一	一
丁	丁
丂	丂
七	七
丄	丄
丅	丅
丆	丆
万	万
丈	丈
三	三
上	上
下	下
丌	丌
不	不
与	与
丏	丏
丐	丐
丑	丑
丒	丒
专	专
且	且
丕	丕
世	世
丗	丗
丘	丘
丙	丙
业	业
丛	丛
东	东
丝	丝
丞	丞
丟	丢
丠	丠
両	両
丢	丢
丣	丣
两	两
严	严
並	并
丧	丧
丨	丨
丩	丩
个	个
丫	丫
丬	丬
中	中
丮	丮
丯	丯
丰	丰
丱	丱
串	串
丳	丳
临	临
丵	丵
丶	丶
丷	丷
丸	丸
丹	丹
为	为
主	主
丼	丼
丽	丽
举	举
丿	丿
乀	乀
乁	乁
乂	乂
乃	乃
乄	乄
久	久
乆	乆
乇	乇
么	么
义	义
乊	乊
之	之
乌	乌
乍	乍
乎	乎
乏	乏
乐	乐
乑	乑
乒	乒
乓	乓
乔	乔
乕	乕
乖	乖
乗	乗
乘	乘
乙	乙
乚	乚
乛	乛
乜	乜
九	九
乞	乞
也	也
习	习
乡	乡
乢	乢
乣	乣
乤	乤
乥	乥
书	书
乧	乧
乨	乨
乩	乩
乪	乪
乫	乫
乬	乬
乭	乭
乮	乮
乯	乯
买	买
乱	乱
乲	乲
乳	乳
乴	乴
乵	乵
乶	乶
乷	乷
乸	乸
乹	乹
乺	乺
乻	乻
乼	乼
乽	乽
乾	干
乿	乿
亀	亀
亁	亁
亂	乱
亃	亃
亄	亄
亅	亅
了	了
亇	亇
予	予
争	争
亊	亊
事	事
二	二
亍	亍
于	于
亏	亏
亐	亐
云	云
互	互
亓	亓
五	五
井	井
亖	亖
亗	亗
亘	亘
亙	亙
亚	亚
些	些
亜	亜
亝	亝
亞	亚
亟	亟
亠	亠
亡	亡
亢	亢
亣	亣
交	交
亥	亥
亦	亦
产	产
亨	亨
亩	亩
亪	亪
享	享
京	京
亭	亭
亮	亮
亯	亯
亰	亰
亱	亱
亲	亲
亳	亳
亴	亴
亵	亵
亶	亶
亷	亷
亸	亸
亹	亹
人	人
亻	亻
亼	亼
亽	亽
亾	亾
亿	亿
什	什
仁	仁
仂	仂
仃	仃
仄	仄
仅	仅
仆	仆
仇	仇
仈	仈
仉	仉
今	今
介	介
仌	仌
仍	仍
从	从
仏	仏
仐	仐
仑	仑
仒	仒
仓	仓
仔	仔
仕	仕
他	他
仗	仗
付	付
仙	仙
仚	仚
仛	仛
仜	仜
仝	仝
仞	仞
仟	仟
仠	仠
仡	仡
仢	仢
代	代
令	令
以	以
仦	仦
仧	仧
仨	仨
仩	仩
仪	仪
仫	仫
们	们
仭	仭
仮	仮
仯	仯
仰	仰
仱	仱
仲	仲
仳	仳
仴	仴
仵	仵
件	件
价	价
仸	仸
仹	仹
仺	仺
任	任
仼	仼
份	份
仾	仾
仿	仿
伀	伀
企	企
伂	伂
伃	伃
伄	伄
伅	伅
伆	伆
伇	伇
伈	伈
伉	伉
伊	伊
伋	伋
伌	伌
伍	伍
伎	伎
伏	伏
伐	伐
休	休
伒	伒
伓	伓
伔	伔
伕	伕
伖	伖
众	众
优	优
伙	伙
会	会
伛	伛
伜	伜
伝	伝
伞	伞
伟	伟
传	传
伡	伡
伢	伢
伣	伣
伤	伤
伥	伥
伦	伦
伧	伧
伨	伨
伩	伩
伪	伪
伫	伫
伬	伬
伭	伭
伮	伮
伯	伯
估	估
伱	伱
伲	伲
伳	伳
伴	伴
伵	伵
伶	伶
伷	伷
伸	伸
伹	伹
伺	伺
伻	伻
似	似
伽	伽
伾	伾
伿	伿
佀	佀
佁	佁
佂	佂
佃	佃
佄	佄
佅	佅
但	但
佇	伫
佈	佈
佉	佉
佊	佊
佋	佋
佌	佌
位	位
低	低
住	住
佐	佐
佑	佑
佒	佒
体	体
佔	佔
何	何
佖	佖
佗	佗
佘	佘
余	余
佚	佚
佛	佛
作	作
佝	佝
佞	佞
佟	佟
你	你
佡	佡
佢	佢
佣	佣
佤	佤
佥	佥
佦	佦
佧	佧
佨	佨
佩	佩
佪	佪
佫	佫
佬	佬
佭	佭
佮	佮
佯	佯
佰	佰
佱	佱
佲	佲
佳	佳
佴	佴
併	并
佶	佶
佷	佷
佸	佸
佹	佹
佺	佺
佻	佻
佼	佼
佽	佽
佾	佾
使	使
侀	侀
侁	侁
侂	侂
侃	侃
侄	侄
侅	侅
來	来
侇	侇
侈	侈
侉	侉
侊	侊
例	例
侌	侌
侍	侍
侎	侎
侏	侏
侐	侐
侑	侑
侒	侒
侓	侓
侔	侔
侕	侕
侖	仑
侗	侗
侘	侘
侙	侙
侚	侚
供	供
侜	侜
依	依
侞	侞
侟	侟
侠	侠
価	価
侢	侢
侣	侣
侤	侤
侥	侥
侦	侦
侧	侧
侨	侨
侩	侩
侪	侪
侫	侫
侬	侬
侭	侭
侮	侮
侯	侯
侰	侰
侱	侱
侲	侲
侳	侳
侴	侴
侵	侵
侶	侣
侷	侷
侸	侸
侹	侹
侺	侺
侻	侻
侼	侼
侽	侽
侾	侾
便	便
俀	俀
俁	俣
係	系
促	促
俄	俄
俅	俅
俆	俆
俇	俇
俈	俈
俉	俉
俊	俊
俋	俋
俌	俌
俍	俍
俎	俎
俏	俏
俐	俐
俑	俑
俒	俒
俓	俓
俔	伣
俕	俕
俖	俖
俗	俗
俘	俘
俙	俙
俚	俚
俛	俛
俜	俜
保	保
俞	俞
俟	俟
俠	侠
信	信
俢	俢
俣	俣
俤	俤
俥	伡
俦	俦
俧	俧
俨	俨
俩	俩
俪	俪
俫	俫
俬	俬
俭	俭
修	修
俯	俯
俰	俰
俱	俱
俲	俲
俳	俳
俴	俴
俵	俵
俶	俶
俷	俷
俸	俸
俹	俹
俺	俺
俻	俻
俼	俼
俽	俽
俾	俾
俿	俿
倀	伥
倁	倁
倂	倂
倃	倃
倄	倄
倅	倅
倆	俩
倇	倇
倈	俫
倉	仓
倊	倊
個	个
倌	倌
倍	倍
倎	倎
倏	倏
倐	倐
們	们
倒	倒
倓	倓
倔	倔
倕	倕
倖	倖
倗	倗
倘	倘
候	候
倚	倚
倛	倛
倜	倜
倝	倝
倞	倞
借	借
倠	倠
倡	倡
倢	倢
倣	倣
値	値
倥	倥
倦	倦
倧	倧
倨	倨
倩	倩
倪	倪
倫	伦
倬	倬
倭	倭
倮	倮
倯	倯
倰	倰
倱	倱
倲	倲
倳	倳
倴	倴
倵	倵
倶	倶
倷	倷
倸	倸
倹	倹
债	债
倻	倻
值	值
倽	倽
倾	倾
倿	倿
偀	偀
偁	偁
偂	偂
偃	偃
偄	偄
偅	偅
偆	偆
假	假
偈	偈
偉	伟
偊	偊
偋	偋
偌	偌
偍	偍
偎	偎
偏	偏
偐	偐
偑	偑
偒	偒
偓	偓
偔	偔
偕	偕
偖	偖
偗	偗
偘	偘
偙	偙
做	做
偛	偛
停	停
偝	偝
偞	偞
偟	偟
偠	偠
偡	偡
偢	偢
偣	偣
偤	偤
健	健
偦	偦
偧	偧
偨	偨
偩	偩
偪	偪
偫	偫
偬	偬
偭	偭
偮	偮
偯	偯
偰	偰
偱	偱
偲	偲
偳	偳
側	侧
偵	侦
偶	偶
偷	偷
偸	偸
偹	偹
偺	偺
偻	偻
偼	偼
偽	伪
偾	偾
偿	偿
傀	傀
傁	傁
傂	傂
傃	傃
傄	傄
傅	傅
傆	傆
傇	傇
傈	傈
傉	傉
傊	傊
傋	傋
傌	傌
傍	傍
傎	傎
傏	傏
傐	傐
傑	杰
傒	傒
傓	傓
傔	傔
傕	傕
傖	伧
傗	傗
傘	伞
備	备
傚	傚
傛	傛
傜	傜
傝	傝
傞	傞
傟	傟
傠	傠
傡	傡
傢	傢
傣	傣
傤	傤
傥	傥
傦	傦
傧	傧
储	储
傩	傩
傪	傪
傫	傫
催	催
傭	佣
傮	傮
傯	偬
傰	傰
傱	傱
傲	傲
傳	传
傴	伛
債	债
傶	傶
傷	伤
傸	傸
傹	傹
傺	傺
傻	傻
傼	傼
傽	傽
傾	倾
傿	傿
僀	僀
僁	僁
僂	偻
僃	僃
僄	僄
僅	仅
僆	僆
僇	僇
僈	僈
僉	佥
僊	僊
僋	僋
僌	僌
働	働
僎	僎
像	像
僐	僐
僑	侨
僒	僒
僓	僓
僔	僔
僕	仆
僖	僖
僗	僗
僘	僘
僙	僙
僚	僚
僛	僛
僜	僜
僝	僝
僞	伪
僟	僟
僠	僠
僡	僡
僢	僢
僣	僣
僤	僤
僥	侥
僦	僦
僧	僧
僨	偾
僩	僩
僪	僪
僫	僫
僬	僬
僭	僭
僮	僮
僯	僯
僰	僰
僱	僱
僲	僲
僳	僳
僴	僴
僵	僵
僶	僶
僷	僷
僸	僸
價	价
僺	僺
僻	僻
僼	僼
僽	僽
僾	僾
僿	僿
儀	仪
儁	儁
儂	侬
儃	儃
億	亿
儅	儅
儆	儆
儇	儇
儈	侩
儉	俭
儊	儊
儋	儋
儌	儌
儍	儍
儎	儎
儏	儏
儐	傧
儑	儑
儒	儒
儓	儓
儔	俦
儕	侪
儖	儖
儗	儗
儘	尽
儙	儙
儚	儚
儛	儛
儜	儜
儝	儝
儞	儞
償	偿
儠	儠
儡	儡
儢	儢
儣	儣
儤	儤
儥	儥
儦	儦
儧	儧
儨	儨
儩	儩
優	优
儫	儫
儬	儬
儭	儭
儮	儮
儯	儯
儰	儰
儱	儱
儲	储
儳	儳
儴	儴
儵	儵
儶	儶
儷	俪
儸	儸
儹	儹
儺	傩
儻	傥
儼	俨
儽	儽
儾	儾
儿	儿
兀	兀
允	允
兂	兂
元	元
兄	兄
充	充
兆	兆
兇	兇
先	先
光	光
兊	兊
克	克
兌	兑
免	免
兎	兎
兏	兏
児	児
兑	兑
兒	儿
兓	兓
兔	兔
兕	兕
兖	兖
兗	兖
兘	兘
兙	兙
党	党
兛	兛
兜	兜
兝	兝
兞	兞
兟	兟
兠	兠
兡	兡
兢	兢
兣	兣
兤	兤
入	入
兦	兦
內	内
全	全
兩	两
兪	兪
八	八
公	公
六	六
兮	兮
兯	兯
兰	兰
共	共
兲	兲
关	关
兴	兴
兵	兵
其	其
具	具
典	典
兹	兹
兺	兺
养	养
兼	兼
兽	兽
兾	兾
兿	兿
冀	冀
冁	冁
冂	冂
冃	冃
冄	冄
内	内
円	円
冇	冇
冈	冈
冉	冉
冊	册
冋	冋
册	册
再	再
冎	冎
冏	冏
冐	冐
冑	冑
冒	冒
冓	冓
冔	冔
冕	冕
冖	冖
冗	冗
冘	冘
写	写
冚	冚
军	军
农	农
冝	冝
冞	冞
冟	冟
冠	冠
冡	冡
冢	冢
冣	冣
冤	冤
冥	冥
冦	冦
冧	冧
冨	冨
冩	冩
冪	幂
冫	冫
冬	冬
冭	冭
冮	冮
冯	冯
冰	冰
冱	冱
冲	冲
决	决
冴	冴
况	况
冶	冶
冷	冷
冸	冸
冹	冹
冺	冺
冻	冻
冼	冼
冽	冽
冾	冾
冿	冿
净	净
凁	凁
凂	凂
凃	凃
凄	凄
凅	凅
准	准
凇	凇
凈	净
凉	凉
凊	凊
凋	凋
凌	凌
凍	冻
凎	凎
减	减
凐	凐
凑	凑
凒	凒
凓	凓
凔	凔
凕	凕
凖	凖
凗	凗
凘	凘
凙	凙
凚	凚
凛	凛
凜	凛
凝	凝
凞	凞
凟	凟
几	几
凡	凡
凢	凢
凣	凣
凤	凤
凥	凥
処	処
凧	凧
凨	凨
凩	凩
凪	凪
凫	凫
凬	凬
凭	凭
凮	凮
凯	凯
凰	凰
凱	凯
凲	凲
凳	凳
凴	凴
凵	凵
凶	凶
凷	凷
凸	凸
凹	凹
出	出
击	击
凼	凼
函	函
凾	凾
凿	凿
刀	刀
刁	刁
刂	刂
刃	刃
刄	刄
刅	刅
分	分
切	切
刈	刈
刉	刉
刊	刊
刋	刋
刌	刌
刍	刍
刎	刎
刏	刏
刐	刐
刑	刑
划	划
刓	刓
刔	刔
刕	刕
刖	刖
列	列
刘	刘
则	则
刚	刚
创	创
刜	刜
初	初
刞	刞
刟	刟
删	删
刡	刡
刢	刢
刣	刣
判	判
別	别
刦	刦
刧	刧
刨	刨
利	利
刪	删
别	别
刬	刬
刭	刭
刮	刮
刯	刯
到	到
刱	刱
刲	刲
刳	刳
刴	刴
刵	刵
制	制
刷	刷
券	券
刹	刹
刺	刺
刻	刻
刼	刼
刽	刽
刾	刾
刿	刿
剀	剀
剁	剁
剂	剂
剃	剃
剄	刭
剅	剅
剆	剆
則	则
剈	剈
剉	剉
削	削
剋	克
剌	剌
前	前
剎	刹
剏	剏
剐	剐
剑	剑
剒	剒
剓	剓
剔	剔
剕	剕
剖	剖
剗	刬
剘	剘
剙	剙
剚	剚
剛	刚
剜	剜
剝	剥
剞	剞
剟	剟
剠	剠
剡	剡
剢	剢
剣	剣
剤	剤
剥	剥
剦	剦
剧	剧
剨	剨
剩	剩
剪	剪
剫	剫
剬	剬
剭	剭
剮	剐
副	副
剰	剰
剱	剱
割	割
剳	剳
剴	剀
創	创
剶	剶
剷	剷
剸	剸
剹	剹
剺	剺
剻	剻
剼	剼
剽	剽
剾	剾
剿	剿
劀	劀
劁	劁
劂	劂
劃	划
劄	劄
劅	劅
劆	劆
劇	剧
劈	劈
劉	刘
劊	刽
劋	劋
劌	刿
劍	剑
劎	劎
劏	劏
劐	劐
劑	剂
劒	劒
劓	劓
劔	劔
劕	劕
劖	劖
劗	劗
劘	劘
劙	劙
劚	劚
力	力
劜	劜
劝	劝
办	办
功	功
加	加
务	务
劢	劢
劣	劣
劤	劤
劥	劥
劦	劦
劧	劧
动	动
助	助
努	努
劫	劫
劬	劬
劭	劭
劮	劮
劯	劯
劰	劰
励	励
劲	劲
劳	劳
労	労
劵	劵
劶	劶
劷	劷
劸	劸
効	効
劺	劺
劻	劻
劼	劼
劽	劽
劾	劾
势	势
勀	勀
勁	劲
勂	勂
勃	勃
勄	勄
勅	勅
勆	勆
勇	勇
勈	勈
勉	勉
勊	勊
勋	勋
勌	勌
勍	勍
勎	勎
勏	勏
勐	勐
勑	勑
勒	勒
勓	勓
勔	勔
動	动
勖	勖
勗	勗
勘	勘
務	务
勚	勚
勛	勋
勜	勜
勝	胜
勞	劳
募	募
勠	勠
勡	勡
勢	势
勣	勣
勤	勤
勥	勥
勦	勦
勧	勧
勨	勨
勩	勚
勪	勪
勫	勫
勬	勬
勭	勭
勮	勮
勯	勯
勰	勰
勱	劢
勲	勲
勳	勳
勴	勴
勵	励
勶	勶
勷	勷
勸	劝
勹	勹
勺	勺
勻	匀
勼	勼
勽	勽
勾	勾
勿	勿
匀	匀
匁	匁
匂	匂
匃	匃
匄	匄
包	包
匆	匆
匇	匇
匈	匈
匉	匉
匊	匊
匋	匋
匌	匌
匍	匍
匎	匎
匏	匏
匐	匐
匑	匑
匒	匒
匓	匓
匔	匔
匕	匕
化	化
北	北
匘	匘
匙	匙
匚	匚
匛	匛
匜	匜
匝	匝
匞	匞
匟	匟
匠	匠
匡	匡
匢	匢
匣	匣
匤	匤
匥	匥
匦	匦
匧	匧
匨	匨
匩	匩
匪	匪
匫	匫
匬	匬
匭	匦
匮	匮
匯	汇
匰	匰
匱	匮
匲	匲
匳	匳
匴	匴
匵	匵
匶	匶
匷	匷
匸	匸
匹	匹
区	区
医	医
匼	匼
匽	匽
匾	匾
匿	匿
區	区
十	十
卂	卂
千	千
卄	卄
卅	卅
卆	卆
升	升
午	午
卉	卉
半	半
卋	卋
卌	卌
卍	卍
华	华
协	协
卐	卐
卑	卑
卒	卒
卓	卓
協	协
单	单
卖	卖
南	南
単	単
卙	卙
博	博
卛	卛
卜	卜
卝	卝
卞	卞
卟	卟
占	占
卡	卡
卢	卢
卣	卣
卤	卤
卥	卥
卦	卦
卧	卧
卨	卨
卩	卩
卪	卪
卫	卫
卬	卬
卭	卭
卮	卮
卯	卯
印	印
危	危
卲	卲
即	即
却	却
卵	卵
卶	卶
卷	卷
卸	卸
卹	卹
卺	卺
卻	却
卼	卼
卽	卽
卾	卾
卿	卿
厀	厀
厁	厁
厂	厂
厃	厃
厄	厄
厅	厅
历	历
厇	厇
厈	厈
厉	厉
厊	厊
压	压
厌	厌
厍	厍
厎	厎
厏	厏
厐	厐
厑	厑
厒	厒
厓	厓
厔	厔
厕	厕
厖	厖
厗	厗
厘	厘
厙	厍
厚	厚
厛	厛
厜	厜
厝	厝
厞	厞
原	原
厠	厠
厡	厡
厢	厢
厣	厣
厤	厤
厥	厥
厦	厦
厧	厧
厨	厨
厩	厩
厪	厪
厫	厫
厬	厬
厭	厌
厮	厮
厯	厯
厰	厰
厱	厱
厲	厉
厳	厳
厴	厣
厵	厵
厶	厶
厷	厷
厸	厸
厹	厹
厺	厺
去	去
厼	厼
厽	厽
厾	厾
县	县
叀	叀
叁	叁
参	参
參	参
叄	叁
叅	叅
叆	叆
叇	叇
又	又
叉	叉
及	及
友	友
双	双
反	反
収	収
叏	叏
叐	叐
发	发
叒	叒
叓	叓
叔	叔
叕	叕
取	取
受	受
变	变
叙	叙
叚	叚
叛	叛
叜	叜
叝	叝
叞	叞
叟	叟
叠	叠
叡	叡
叢	丛
口	口
古	古
句	句
另	另
叧	叧
叨	叨
叩	叩
只	只
叫	叫
召	召
叭	叭
叮	叮
可	可
台	台
叱	叱
史	史
右	右
叴	叴
叵	叵
叶	叶
号	号
司	司
叹	叹
叺	叺
叻	叻
叼	叼
叽	叽
叾	叾
叿	叿
吀	吀
吁	吁
吂	吂
吃	吃
各	各
吅	吅
吆	吆
吇	吇
合	合
吉	吉
吊	吊
吋	吋
同	同
名	名
后	后
吏	吏
吐	吐
向	向
吒	咤
吓	吓
吔	吔
吕	吕
吖	吖
吗	吗
吘	吘
吙	吙
吚	吚
君	君
吜	吜
吝	吝
吞	吞
吟	吟
吠	吠
吡	吡
吢	吢
吣	吣
吤	吤
吥	吥
否	否
吧	吧
吨	吨
吩	吩
吪	吪
含	含
听	听
吭	吭
吮	吮
启	启
吰	吰
吱	吱
吲	吲
吳	吴
吴	吴
吵	吵
吶	呐
吷	吷
吸	吸
吹	吹
吺	吺
吻	吻
吼	吼
吽	吽
吾	吾
吿	吿
呀	呀
呁	呁
呂	吕
呃	呃
呄	呄
呅	呅
呆	呆
呇	呇
呈	呈
呉	呉
告	告
呋	呋
呌	呌
呍	呍
呎	呎
呏	呏
呐	呐
呑	呑
呒	呒
呓	呓
呔	呔
呕	呕
呖	呖
呗	呗
员	员
呙	呙
呚	呚
呛	呛
呜	呜
呝	呝
呞	呞
呟	呟
呠	呠
呡	呡
呢	呢
呣	呣
呤	呤
呥	呥
呦	呦
呧	呧
周	周
呩	呩
呪	呪
呫	呫
呬	呬
呭	呭
呮	呮
呯	呯
呰	呰
呱	呱
呲	呲
味	味
呴	呴
呵	呵
呶	呶
呷	呷
呸	呸
呹	呹
呺	呺
呻	呻
呼	呼
命	命
呾	呾
呿	呿
咀	咀
咁	咁
咂	咂
咃	咃
咄	咄
咅	咅
咆	咆
咇	咇
咈	咈
咉	咉
咊	咊
咋	咋
和	和
咍	咍
咎	咎
咏	咏
咐	咐
咑	咑
咒	咒
咓	咓
咔	咔
咕	咕
咖	咖
咗	咗
咘	咘
咙	咙
咚	咚
咛	咛
咜	咜
咝	咝
咞	咞
咟	咟
咠	咠
咡	咡
咢	咢
咣	咣
咤	咤
咥	咥
咦	咦
咧	咧
咨	咨
咩	咩
咪	咪
咫	咫
咬	咬
咭	咭
咮	咮
咯	咯
咰	咰
咱	咱
咲	咲
咳	咳
咴	咴
咵	咵
咶	咶
咷	咷
咸	咸
咹	咹
咺	咺
咻	咻
咼	呙
咽	咽
咾	咾
咿	咿
哀	哀
品	品
哂	哂
哃	哃
哄	哄
哅	哅
哆	哆
哇	哇
哈	哈
哉	哉
哊	哊
哋	哋
哌	哌
响	响
哎	哎
哏	哏
哐	哐
哑	哑
哒	哒
哓	哓
哔	哔
哕	哕
哖	哖
哗	哗
哘	哘
哙	哙
哚	哚
哛	哛
哜	哜
哝	哝
哞	哞
哟	哟
哠	哠
員	员
哢	哢
哣	哣
哤	哤
哥	哥
哦	哦
哧	哧
哨	哨
哩	哩
哪	哪
哫	哫
哬	哬
哭	哭
哮	哮
哯	哯
哰	哰
哱	哱
哲	哲
哳	哳
哴	哴
哵	哵
哶	哶
哷	哷
哸	哸
哹	哹
哺	哺
哻	哻
哼	哼
哽	哽
哾	哾
哿	哿
唀	唀
唁	唁
唂	唂
唃	唃
唄	呗
唅	唅
唆	唆
唇	唇
唈	唈
唉	唉
唊	唊
唋	唋
唌	唌
唍	唍
唎	唎
唏	唏
唐	唐
唑	唑
唒	唒
唓	唓
唔	唔
唕	唕
唖	唖
唗	唗
唘	唘
唙	唙
唚	吣
唛	唛
唜	唜
唝	唝
唞	唞
唟	唟
唠	唠
唡	唡
唢	唢
唣	唣
唤	唤
唥	唥
唦	唦
唧	唧
唨	唨
唩	唩
唪	唪
唫	唫
唬	唬
唭	唭
售	售
唯	唯
唰	唰
唱	唱
唲	唲
唳	唳
唴	唴
唵	唵
唶	唶
唷	唷
唸	唸
唹	唹
唺	唺
唻	唻
唼	唼
唽	唽
唾	唾
唿	唿
啀	啀
啁	啁
啂	啂
啃	啃
啄	啄
啅	啅
商	商
啇	啇
啈	啈
啉	啉
啊	啊
啋	啋
啌	啌
啍	啍
啎	啎
問	问
啐	啐
啑	啑
啒	啒
啓	啓
啔	啔
啕	啕
啖	啖
啗	啗
啘	啘
啙	啙
啚	啚
啛	啛
啜	啜
啝	啝
啞	哑
啟	启
啠	啠
啡	啡
啢	唡
啣	啣
啤	啤
啥	啥
啦	啦
啧	啧
啨	啨
啩	啩
啪	啪
啫	啫
啬	啬
啭	啭
啮	啮
啯	啯
啰	啰
啱	啱
啲	啲
啳	啳
啴	啴
啵	啵
啶	啶
啷	啷
啸	啸
啹	啹
啺	啺
啻	啻
啼	啼
啽	啽
啾	啾
啿	啿
喀	喀
喁	喁
喂	喂
喃	喃
善	善
喅	喅
喆	喆
喇	喇
喈	喈
喉	喉
喊	喊
喋	喋
喌	喌
喍	喍
喎	喎
喏	喏
喐	喐
喑	喑
喒	喒
喓	喓
喔	喔
喕	喕
喖	喖
喗	喗
喘	喘
喙	喙
喚	唤
喛	喛
喜	喜
喝	喝
喞	喞
喟	喟
喠	喠
喡	喡
喢	喢
喣	喣
喤	喤
喥	喥
喦	喦
喧	喧
喨	喨
喩	喩
喪	丧
喫	喫
喬	乔
喭	喭
單	单
喯	喯
喰	喰
喱	喱
喲	哟
喳	喳
喴	喴
喵	喵
営	営
喷	喷
喸	喸
喹	喹
喺	喺
喻	喻
喼	喼
喽	喽
喾	喾
喿	喿
嗀	嗀
嗁	嗁
嗂	嗂
嗃	嗃
嗄	嗄
嗅	嗅
嗆	呛
嗇	啬
嗈	嗈
嗉	嗉
嗊	唝
嗋	嗋
嗌	嗌
嗍	嗍
嗎	吗
嗏	嗏
嗐	嗐
嗑	嗑
嗒	嗒
嗓	嗓
嗔	嗔
嗕	嗕
嗖	嗖
嗗	嗗
嗘	嗘
嗙	嗙
嗚	呜
嗛	嗛
嗜	嗜
嗝	嗝
嗞	嗞
嗟	嗟
嗠	嗠
嗡	嗡
嗢	嗢
嗣	嗣
嗤	嗤
嗥	嗥
嗦	嗦
嗧	嗧
嗨	嗨
嗩	唢
嗪	嗪
嗫	嗫
嗬	嗬
嗭	嗭
嗮	嗮
嗯	嗯
嗰	嗰
嗱	嗱
嗲	嗲
嗳	嗳
嗴	嗴
嗵	嗵
嗶	哔
嗷	嗷
嗸	嗸
嗹	嗹
嗺	嗺
嗻	嗻
嗼	嗼
嗽	嗽
嗾	嗾
嗿	嗿
嘀	嘀
嘁	嘁
嘂	嘂
嘃	嘃
嘄	嘄
嘅	嘅
嘆	叹
嘇	嘇
嘈	嘈
嘉	嘉
嘊	嘊
嘋	嘋
嘌	嘌
嘍	喽
嘎	嘎
嘏	嘏
嘐	嘐
嘑	嘑
嘒	嘒
嘓	啯
嘔	呕
嘕	嘕
嘖	啧
嘗	尝
嘘	嘘
嘙	嘙
嘚	嘚
嘛	嘛
嘜	唛
嘝	嘝
嘞	嘞
嘟	嘟
嘠	嘠
嘡	嘡
嘢	嘢
嘣	嘣
嘤	嘤
嘥	嘥
嘦	嘦
嘧	嘧
嘨	嘨
嘩	哗
嘪	嘪
嘫	嘫
嘬	嘬
嘭	嘭
嘮	唠
嘯	啸
嘰	叽
嘱	嘱
嘲	嘲
嘳	嘳
嘴	嘴
嘵	哓
嘶	嘶
嘷	嘷
嘸	呒
嘹	嘹
嘺	嘺
嘻	嘻
嘼	嘼
嘽	啴
嘾	嘾
嘿	嘿
噀	噀
噁	噁
噂	噂
噃	噃
噄	噄
噅	噅
噆	噆
噇	噇
噈	噈
噉	噉
噊	噊
噋	噋
噌	噌
噍	噍
噎	噎
噏	噏
噐	噐
噑	噑
噒	噒
噓	嘘
噔	噔
噕	噕
噖	噖
噗	噗
噘	噘
噙	噙
噚	噚
噛	噛
噜	噜
噝	咝
噞	噞
噟	噟
噠	哒
噡	噡
噢	噢
噣	噣
噤	噤
噥	哝
噦	哕
噧	噧
器	器
噩	噩
噪	噪
噫	噫
噬	噬
噭	噭
噮	噮
噯	嗳
噰	噰
噱	噱
噲	哙
噳	噳
噴	喷
噵	噵
噶	噶
噷	噷
噸	吨
噹	当
噺	噺
噻	噻
噼	噼
噽	噽
噾	噾
噿	噿
嚀	咛
嚁	嚁
嚂	嚂
嚃	嚃
嚄	嚄
嚅	嚅
嚆	嚆
嚇	吓
嚈	嚈
嚉	嚉
嚊	嚊
嚋	嚋
嚌	哜
嚍	嚍
嚎	嚎
嚏	嚏
嚐	嚐
嚑	嚑
嚒	嚒
嚓	嚓
嚔	嚔
嚕	噜
嚖	嚖
嚗	嚗
嚘	嚘
嚙	啮
嚚	嚚
嚛	嚛
嚜	嚜
嚝	嚝
嚞	嚞
嚟	嚟
嚠	嚠
嚡	嚡
嚢	嚢
嚣	嚣
嚤	嚤
嚥	嚥
嚦	呖
嚧	嚧
嚨	咙
嚩	嚩
嚪	嚪
嚫	嚫
嚬	嚬
嚭	嚭
嚮	嚮
嚯	嚯
嚰	嚰
嚱	嚱
嚲	亸
嚳	喾
嚴	严
嚵	嚵
嚶	嘤
嚷	嚷
嚸	嚸
嚹	嚹
嚺	嚺
嚻	嚻
嚼	嚼
嚽	嚽
嚾	嚾
嚿	嚿
囀	啭
囁	嗫
囂	嚣
囃	囃
囄	囄
囅	冁
囆	囆
囇	囇
囈	呓
囉	啰
囊	囊
囋	囋
囌	囌
囍	囍
囎	囎
囏	囏
囐	囐
囑	嘱
囒	囒
囓	囓
囔	囔
囕	囕
囖	囖
囗	囗
囘	囘
囙	囙
囚	囚
四	四
囜	囜
囝	囝
回	回
囟	囟
因	因
囡	囡
团	团
団	団
囤	囤
囥	囥
囦	囦
囧	囧
囨	囨
囩	囩
囪	囱
囫	囫
囬	囬
园	园
囮	囮
囯	囯
困	困
囱	囱
囲	囲
図	図
围	围
囵	囵
囶	囶
囷	囷
囸	囸
囹	囹
固	固
囻	囻
囼	囼
国	国
图	图
囿	囿
圀	圀
圁	圁
圂	圂
圃	圃
圄	圄
圅	圅
圆	圆
圇	囵
圈	圈
圉	圉
圊	圊
國	国
圌	圌
圍	围
圎	圎
圏	圏
圐	圐
圑	圑
園	园
圓	圆
圔	圔
圕	圕
圖	图
圗	圗
團	团
圙	圙
圚	圚
圛	圛
圜	圜
圝	圝
圞	圞
土	土
圠	圠
圡	圡
圢	圢
圣	圣
圤	圤
圥	圥
圦	圦
圧	圧
在	在
圩	圩
圪	圪
圫	圫
圬	圬
圭	圭
圮	圮
圯	圯
地	地
圱	圱
圲	圲
圳	圳
圴	圴
圵	圵
圶	圶
圷	圷
圸	圸
圹	圹
场	场
圻	圻
圼	圼
圽	圽
圾	圾
圿	圿
址	址
坁	坁
坂	坂
坃	坃
坄	坄
坅	坅
坆	坆
均	均
坈	坈
坉	坉
坊	坊
坋	坋
坌	坌
坍	坍
坎	坎
坏	坏
坐	坐
坑	坑
坒	坒
坓	坓
坔	坔
坕	坕
坖	坖
块	块
坘	坘
坙	坙
坚	坚
坛	坛
坜	坜
坝	坝
坞	坞
坟	坟
坠	坠
坡	坡
坢	坢
坣	坣
坤	坤
坥	坥
坦	坦
坧	坧
坨	坨
坩	坩
坪	坪
坫	坫
坬	坬
坭	坭
坮	坮
坯	坯
坰	坰
坱	坱
坲	坲
坳	坳
坴	坴
坵	坵
坶	坶
坷	坷
坸	坸
坹	坹
坺	坺
坻	坻
坼	坼
坽	坽
坾	坾
坿	坿
垀	垀
垁	垁
垂	垂
垃	垃
垄	垄
垅	垅
垆	垆
垇	垇
垈	垈
垉	垉
垊	垊
型	型
垌	垌
垍	垍
垎	垎
垏	垏
垐	垐
垑	垑
垒	垒
垓	垓
垔	垔
垕	垕
垖	垖
垗	垗
垘	垘
垙	垙
垚	垚
垛	垛
垜	垜
垝	垝
垞	垞
垟	垟
垠	垠
垡	垡
垢	垢
垣	垣
垤	垤
垥	垥
垦	垦
垧	垧
垨	垨
垩	垩
垪	垪
垫	垫
垬	垬
垭	垭
垮	垮
垯	垯
垰	垰
垱	垱
垲	垲
垳	垳
垴	垴
垵	埯
垶	垶
垷	垷
垸	垸
垹	垹
垺	垺
垻	垻
垼	垼
垽	垽
垾	垾
垿	垿
埀	埀
埁	埁
埂	埂
埃	埃
埄	埄
埅	埅
埆	埆
埇	埇
埈	埈
埉	埉
埊	埊
埋	埋
埌	埌
埍	埍
城	城
埏	埏
埐	埐
埑	埑
埒	埒
埓	埓
埔	埔
埕	埕
埖	埖
埗	埗
埘	埘
埙	埙
埚	埚
埛	埛
埜	埜
埝	埝
埞	埞
域	域
埠	埠
埡	垭
埢	埢
埣	埣
埤	埤
埥	埥
埦	埦
埧	埧
埨	埨
埩	埩
埪	埪
埫	埫
埬	埬
埭	埭
埮	埮
埯	埯
埰	采
埱	埱
埲	埲
埳	埳
埴	埴
埵	埵
埶	埶
執	执
埸	埸
培	培
基	基
埻	埻
埼	埼
埽	埽
埾	埾
埿	埿
堀	堀
堁	堁
堂	堂
堃	堃
堄	堄
堅	坚
堆	堆
堇	堇
堈	堈
堉	堉
堊	垩
堋	堋
堌	堌
堍	堍
堎	堎
堏	堏
堐	堐
堑	堑
堒	堒
堓	堓
堔	堔
堕	堕
堖	垴
堗	堗
堘	堘
堙	堙
堚	堚
堛	堛
堜	堜
堝	埚
堞	堞
堟	堟
堠	堠
堡	堡
堢	堢
堣	堣
堤	堤
堥	堥
堦	堦
堧	堧
堨	堨
堩	堩
堪	堪
堫	堫
堬	堬
堭	堭
堮	堮
堯	尧
堰	堰
報	报
堲	堲
堳	堳
場	场
堵	堵
堶	堶
堷	堷
堸	堸
堹	堹
堺	堺
堻	堻
堼	堼
堽	堽
堾	堾
堿	堿
塀	塀
塁	塁
塂	塂
塃	塃
塄	塄
塅	塅
塆	塆
塇	塇
塈	塈
塉	塉
塊	块
塋	茔
塌	塌
塍	塍
塎	塎
塏	垲
塐	塐
塑	塑
塒	埘
塓	塓
塔	塔
塕	塕
塖	塖
塗	涂
塘	塘
塙	塙
塚	塚
塛	塛
塜	塜
塝	塝
塞	塞
塟	塟
塠	塠
塡	塡
塢	坞
塣	塣
塤	埙
塥	塥
塦	塦
塧	塧
塨	塨
塩	塩
塪	塪
填	填
塬	塬
塭	塭
塮	塮
塯	塯
塰	塰
塱	塱
塲	塲
塳	塳
塴	塴
塵	尘
塶	塶
塷	塷
塸	塸
塹	堑
塺	塺
塻	塻
塼	塼
塽	塽
塾	塾
塿	塿
墀	墀
墁	墁
墂	墂
境	境
墄	墄
墅	墅
墆	墆
墇	墇
墈	墈
墉	墉
墊	垫
墋	墋
墌	墌
墍	墍
墎	墎
墏	墏
墐	墐
墑	墑
墒	墒
墓	墓
墔	墔
墕	墕
墖	墖
増	増
墘	墘
墙	墙
墚	墚
墛	墛
墜	坠
墝	墝
增	增
墟	墟
墠	墠
墡	墡
墢	墢
墣	墣
墤	墤
墥	墥
墦	墦
墧	墧
墨	墨
墩	墩
墪	墪
墫	墫
墬	墬
墭	墭
墮	堕
墯	墯
墰	墰
墱	墱
墲	墲
墳	坟
墴	墴
墵	墵
墶	墶
墷	墷
墸	墸
墹	墹
墺	墺
墻	墻
墼	墼
墽	墽
墾	垦
墿	墿
壀	壀
壁	壁
壂	壂
壃	壃
壄	壄
壅	壅
壆	壆
壇	坛
壈	壈
壉	壉
壊	壊
壋	垱
壌	壌
壍	壍
壎	壎
壏	壏
壐	壐
壑	壑
壒	壒
壓	压
壔	壔
壕	壕
壖	壖
壗	壗
壘	垒
壙	圹
壚	垆
壛	壛
壜	壜
壝	壝
壞	坏
壟	垄
壠	垅
壡	壡
壢	坜
壣	壣
壤	壤
壥	壥
壦	壦
壧	壧
壨	壨
壩	坝
壪	壪
士	士
壬	壬
壭	壭
壮	壮
壯	壮
声	声
壱	壱
売	売
壳	壳
壴	壴
壵	壵
壶	壶
壷	壷
壸	壸
壹	壹
壺	壶
壻	壻
壼	壸
壽	寿
壾	壾
壿	壿
夀	夀
夁	夁
夂	夂
夃	夃
处	处
夅	夅
夆	夆
备	备
夈	夈
変	変
夊	夊
夋	夋
夌	夌
复	复
夎	夎
夏	夏
夐	夐
夑	夑
夒	夒
夓	夓
夔	夔
夕	夕
外	外
夗	夗
夘	夘
夙	夙
多	多
夛	夛
夜	夜
夝	夝
夞	夞
够	够
夠	够
夡	夡
夢	梦
夣	夣
夤	夤
夥	夥
夦	夦
大	大
夨	夨
天	天
太	太
夫	夫
夬	夬
夭	夭
央	央
夯	夯
夰	夰
失	失
夲	夲
夳	夳
头	头
夵	夵
夶	夶
夷	夷
夸	夸
夹	夹
夺	夺
夻	夻
夼	夼
夽	夽
夾	夹
夿	夿
奀	奀
奁	奁
奂	奂
奃	奃
奄	奄
奅	奅
奆	奆
奇	奇
奈	奈
奉	奉
奊	奊
奋	奋
奌	奌
奍	奍
奎	奎
奏	奏
奐	奂
契	契
奒	奒
奓	奓
奔	奔
奕	奕
奖	奖
套	套
奘	奘
奙	奙
奚	奚
奛	奛
奜	奜
奝	奝
奞	奞
奟	奟
奠	奠
奡	奡
奢	奢
奣	奣
奤	奤
奥	奥
奦	奦
奧	奥
奨	奨
奩	奁
奪	夺
奫	奫
奬	奬
奭	奭
奮	奋
奯	奯
奰	奰
奱	奱
奲	奲
女	女
奴	奴
奵	奵
奶	奶
奷	奷
奸	奸
她	她
奺	奺
奻	奻
奼	姹
好	好
奾	奾
奿	奿
妀	妀
妁	妁
如	如
妃	妃
妄	妄
妅	妅
妆	妆
妇	妇
妈	妈
妉	妉
妊	妊
妋	妋
妌	妌
妍	妍
妎	妎
妏	妏
妐	妐
妑	妑
妒	妒
妓	妓
妔	妔
妕	妕
妖	妖
妗	妗
妘	妘
妙	妙
妚	妚
妛	妛
妜	妜
妝	妆
妞	妞
妟	妟
妠	妠
妡	妡
妢	妢
妣	妣
妤	妤
妥	妥
妦	妦
妧	妧
妨	妨
妩	妩
妪	妪
妫	妫
妬	妬
妭	妭
妮	妮
妯	妯
妰	妰
妱	妱
妲	妲
妳	妳
妴	妴
妵	妵
妶	妶
妷	妷
妸	妸
妹	妹
妺	妺
妻	妻
妼	妼
妽	妽
妾	妾
妿	妿
姀	姀
姁	姁
姂	姂
姃	姃
姄	姄
姅	姅
姆	姆
姇	姇
姈	姈
姉	姉
姊	姊
始	始
姌	姌
姍	姗
姎	姎
姏	姏
姐	姐
姑	姑
姒	姒
姓	姓
委	委
姕	姕
姖	姖
姗	姗
姘	姘
姙	姙
姚	姚
姛	姛
姜	姜
姝	姝
姞	姞
姟	姟
姠	姠
姡	姡
姢	姢
姣	姣
姤	姤
姥	姥
姦	奸
姧	姧
姨	姨
姩	姩
姪	姪
姫	姫
姬	姬
姭	姭
姮	姮
姯	姯
姰	姰
姱	姱
姲	姲
姳	姳
姴	姴
姵	姵
姶	姶
姷	姷
姸	姸
姹	姹
姺	姺
姻	姻
姼	姼
姽	姽
姾	姾
姿	姿
娀	娀
威	威
娂	娂
娃	娃
娄	娄
娅	娅
娆	娆
娇	娇
娈	娈
娉	娉
娊	娊
娋	娋
娌	娌
娍	娍
娎	娎
娏	娏
娐	娐
娑	娑
娒	娒
娓	娓
娔	娔
娕	娕
娖	娖
娗	娗
娘	娘
娙	娙
娚	娚
娛	娱
娜	娜
娝	娝
娞	娞
娟	娟
娠	娠
娡	娡
娢	娢
娣	娣
娤	娤
娥	娥
娦	娦
娧	娧
娨	娨
娩	娩
娪	娪
娫	娫
娬	娬
娭	娭
娮	娮
娯	娯
娰	娰
娱	娱
娲	娲
娳	娳
娴	娴
娵	娵
娶	娶
娷	娷
娸	娸
娹	娹
娺	娺
娻	娻
娼	娼
娽	娽
娾	娾
娿	娿
婀	婀
婁	娄
婂	婂
婃	婃
婄	婄
婅	婅
婆	婆
婇	婇
婈	婈
婉	婉
婊	婊
婋	婋
婌	婌
婍	婍
婎	婎
婏	婏
婐	婐
婑	婑
婒	婒
婓	婓
婔	婔
婕	婕
婖	婖
婗	婗
婘	婘
婙	婙
婚	婚
婛	婛
婜	婜
婝	婝
婞	婞
婟	婟
婠	婠
婡	婡
婢	婢
婣	婣
婤	婤
婥	婥
婦	妇
婧	婧
婨	婨
婩	婩
婪	婪
婫	婫
婬	婬
婭	娅
婮	婮
婯	婯
婰	婰
婱	婱
婲	婲
婳	婳
婴	婴
婵	婵
婶	婶
婷	婷
婸	婸
婹	婹
婺	婺
婻	婻
婼	婼
婽	婽
婾	婾
婿	婿
媀	媀
媁	媁
媂	媂
媃	媃
媄	媄
媅	媅
媆	媆
媇	媇
媈	媈
媉	媉
媊	媊
媋	媋
媌	媌
媍	媍
媎	媎
媏	媏
媐	媐
媑	媑
媒	媒
媓	媓
媔	媔
媕	媕
媖	媖
媗	媗
媘	媘
媙	媙
媚	媚
媛	媛
媜	媜
媝	媝
媞	媞
媟	媟
媠	媠
媡	媡
媢	媢
媣	媣
媤	媤
媥	媥
媦	媦
媧	娲
媨	媨
媩	媩
媪	媪
媫	媫
媬	媬
媭	媭
媮	媮
媯	妫
媰	媰
媱	媱
媲	媲
媳	媳
媴	媴
媵	媵
媶	媶
媷	媷
媸	媸
媹	媹
媺	媺
媻	媻
媼	媪
媽	妈
媾	媾
媿	媿
嫀	嫀
嫁	嫁
嫂	嫂
嫃	嫃
嫄	嫄
嫅	嫅
嫆	嫆
嫇	嫇
嫈	嫈
嫉	嫉
嫊	嫊
嫋	嫋
嫌	嫌
嫍	嫍
嫎	嫎
嫏	嫏
嫐	嫐
嫑	嫑
嫒	嫒
嫓	嫓
嫔	嫔
嫕	嫕
嫖	嫖
嫗	妪
嫘	嫘
嫙	嫙
嫚	嫚
嫛	嫛
嫜	嫜
嫝	嫝
嫞	嫞
嫟	嫟
嫠	嫠
嫡	嫡
嫢	嫢
嫣	嫣
嫤	嫤
嫥	嫥
嫦	嫦
嫧	嫧
嫨	嫨
嫩	嫩
嫪	嫪
嫫	嫫
嫬	嫬
嫭	嫭
嫮	嫮
嫯	嫯
嫰	嫰
嫱	嫱
嫲	嫲
嫳	嫳
嫴	嫴
嫵	妩
嫶	嫶
嫷	嫷
嫸	嫸
嫹	嫹
嫺	嫺
嫻	娴
嫼	嫼
嫽	嫽
嫾	嫾
嫿	婳
嬀	嬀
嬁	嬁
嬂	嬂
嬃	媭
嬄	嬄
嬅	嬅
嬆	嬆
嬇	嬇
嬈	娆
嬉	嬉
嬊	嬊
嬋	婵
嬌	娇
嬍	嬍
嬎	嬎
嬏	嬏
嬐	嬐
嬑	嬑
嬒	嬒
嬓	嬓
嬔	嬔
嬕	嬕
嬖	嬖
嬗	嬗
嬘	嬘
嬙	嫱
嬚	嬚
嬛	嬛
嬜	嬜
嬝	嬝
嬞	嬞
嬟	嬟
嬠	嬠
嬡	嫒
嬢	嬢
嬣	嬣
嬤	嬷
嬥	嬥
嬦	嬦
嬧	嬧
嬨	嬨
嬩	嬩
嬪	嫔
嬫	嬫
嬬	嬬
嬭	嬭
嬮	嬮
嬯	嬯
嬰	婴
嬱	嬱
嬲	嬲
嬳	嬳
嬴	嬴
嬵	嬵
嬶	嬶
嬷	嬷
嬸	婶
嬹	嬹
嬺	嬺
嬻	嬻
嬼	嬼
嬽	嬽
嬾	嬾
嬿	嬿
孀	孀
孁	孁
孂	孂
孃	孃
孄	孄
孅	孅
孆	孆
孇	孇
孈	孈
孉	孉
孊	孊
孋	孋
孌	娈
孍	孍
孎	孎
孏	孏
子	子
孑	孑
孒	孒
孓	孓
孔	孔
孕	孕
孖	孖
字	字
存	存
孙	孙
孚	孚
孛	孛
孜	孜
孝	孝
孞	孞
孟	孟
孠	孠
孡	孡
孢	孢
季	季
孤	孤
孥	孥
学	学
孧	孧
孨	孨
孩	孩
孪	孪
孫	孙
孬	孬
孭	孭
孮	孮
孯	孯
孰	孰
孱	孱
孲	孲
孳	孳
孴	孴
孵	孵
孶	孶
孷	孷
學	学
孹	孹
孺	孺
孻	孻
孼	孼
孽	孽
孾	孾
孿	孪
宀	宀
宁	宁
宂	宂
它	它
宄	宄
宅	宅
宆	宆
宇	宇
守	守
安	安
宊	宊
宋	宋
完	完
宍	宍
宎	宎
宏	宏
宐	宐
宑	宑
宒	宒
宓	宓
宔	宔
宕	宕
宖	宖
宗	宗
官	官
宙	宙
定	定
宛	宛
宜	宜
宝	宝
实	实
実	実
宠	宠
审	审
客	客
宣	宣
室	室
宥	宥
宦	宦
宧	宧
宨	宨
宩	宩
宪	宪
宫	宫
宬	宬
宭	宭
宮	宫
宯	宯
宰	宰
宱	宱
宲	宲
害	害
宴	宴
宵	宵
家	家
宷	宷
宸	宸
容	容
宺	宺
宻	宻
宼	宼
宽	宽
宾	宾
宿	宿
寀	寀
寁	寁
寂	寂
寃	寃
寄	寄
寅	寅
密	密
寇	寇
寈	寈
寉	寉
寊	寊
寋	寋
富	富
寍	寍
寎	寎
寏	寏
寐	寐
寑	寑
寒	寒
寓	寓
寔	寔
寕	寕
寖	寖
寗	寗
寘	寘
寙	寙
寚	寚
寛	寛
寜	寜
寝	寝
寞	寞
察	察
寠	寠
寡	寡
寢	寝
寣	寣
寤	寤
寥	寥
實	实
寧	宁
寨	寨
審	审
寪	寪
寫	写
寬	宽
寭	寭
寮	寮
寯	寯
寰	寰
寱	寱
寲	寲
寳	寳
寴	寴
寵	宠
寶	宝
寷	寷
寸	寸
对	对
寺	寺
寻	寻
导	导
寽	寽
対	対
寿	寿
尀	尀
封	封
専	専
尃	尃
射	射
尅	尅
将	将
將	将
專	专
尉	尉
尊	尊
尋	寻
尌	尌
對	对
導	导
小	小
尐	尐
少	少
尒	尒
尓	尓
尔	尔
尕	尕
尖	尖
尗	尗
尘	尘
尙	尙
尚	尚
尛	尛
尜	尜
尝	尝
尞	尞
尟	尟
尠	尠
尡	尡
尢	尢
尣	尣
尤	尤
尥	尥
尦	尦
尧	尧
尨	尨
尩	尩
尪	尪
尫	尫
尬	尬
尭	尭
尮	尮
尯	尯
尰	尰
就	就
尲	尲
尳	尳
尴	尴
尵	尵
尶	尶
尷	尴
尸	尸
尹	尹
尺	尺
尻	尻
尼	尼
尽	尽
尾	尾
尿	尿
局	局
屁	屁
层	层
屃	屃
屄	屄
居	居
屆	届
屇	屇
屈	屈
屉	屉
届	届
屋	屋
屌	屌
屍	尸
屎	屎
屏	屏
屐	屐
屑	屑
屒	屒
屓	屃
屔	屔
展	展
屖	屖
屗	屗
屘	屘
屙	屙
屚	屚
屛	屛
屜	屉
屝	屝
属	属
屟	屟
屠	屠
屡	屡
屢	屡
屣	屣
層	层
履	履
屦	屦
屧	屧
屨	屦
屩	屩
屪	屪
屫	屫
屬	属
屭	屭
屮	屮
屯	屯
屰	屰
山	山
屲	屲
屳	屳
屴	屴
屵	屵
屶	屶
屷	屷
屸	屸
屹	屹
屺	屺
屻	屻
屼	屼
屽	屽
屾	屾
屿	屿
岀	岀
岁	岁
岂	岂
岃	岃
岄	岄
岅	岅
岆	岆
岇	岇
岈	岈
岉	岉
岊	岊
岋	岋
岌	岌
岍	岍
岎	岎
岏	岏
岐	岐
岑	岑
岒	岒
岓	岓
岔	岔
岕	岕
岖	岖
岗	岗
岘	岘
岙	岙
岚	岚
岛	岛
岜	岜
岝	岝
岞	岞
岟	岟
岠	岠
岡	冈
岢	岢
岣	岣
岤	岤
岥	岥
岦	岦
岧	岧
岨	岨
岩	岩
岪	岪
岫	岫
岬	岬
岭	岭
岮	岮
岯	岯
岰	岰
岱	岱
岲	岲
岳	岳
岴	岴
岵	岵
岶	岶
岷	岷
岸	岸
岹	岹
岺	岺
岻	岻
岼	岼
岽	岽
岾	岾
岿	岿
峀	峀
峁	峁
峂	峂
峃	峃
峄	峄
峅	峅
峆	峆
峇	峇
峈	峈
峉	峉
峊	峊
峋	峋
峌	峌
峍	峍
峎	峎
峏	峏
峐	峐
峑	峑
峒	峒
峓	峓
峔	峔
峕	峕
峖	峖
峗	峗
峘	峘
峙	峙
峚	峚
峛	峛
峜	峜
峝	峝
峞	峞
峟	峟
峠	峠
峡	峡
峢	峢
峣	峣
峤	峤
峥	峥
峦	峦
峧	峧
峨	峨
峩	峩
峪	峪
峫	峫
峬	峬
峭	峭
峮	峮
峯	峯
峰	峰
峱	峱
峲	峲
峳	峳
峴	岘
峵	峵
島	岛
峷	峷
峸	峸
峹	峹
峺	峺
峻	峻
峼	峼
峽	峡
峾	峾
峿	峿
崀	崀
崁	崁
崂	崂
崃	崃
崄	崄
崅	崅
崆	崆
崇	崇
崈	崈
崉	崉
崊	崊
崋	崋
崌	崌
崍	崃
崎	崎
崏	崏
崐	崐
崑	崑
崒	崒
崓	崓
崔	崔
崕	崕
崖	崖
崗	岗
崘	崘
崙	崙
崚	崚
崛	崛
崜	崜
崝	崝
崞	崞
崟	崟
崠	崠
崡	崡
崢	峥
崣	崣
崤	崤
崥	崥
崦	崦
崧	崧
崨	崨
崩	崩
崪	崪
崫	崫
崬	岽
崭	崭
崮	崮
崯	崯
崰	崰
崱	崱
崲	崲
崳	崳
崴	崴
崵	崵
崶	崶
崷	崷
崸	崸
崹	崹
崺	崺
崻	崻
崼	崼
崽	崽
崾	崾
崿	崿
嵀	嵀
嵁	嵁
嵂	嵂
嵃	嵃
嵄	嵄
嵅	嵅
嵆	嵆
嵇	嵇
嵈	嵈
嵉	嵉
嵊	嵊
嵋	嵋
嵌	嵌
嵍	嵍
嵎	嵎
嵏	嵏
嵐	岚
嵑	嵑
嵒	嵒
嵓	嵓
嵔	嵔
嵕	嵕
嵖	嵖
嵗	嵗
嵘	嵘
嵙	嵙
嵚	嵚
嵛	嵛
嵜	嵜
嵝	嵝
嵞	嵞
嵟	嵟
嵠	嵠
嵡	嵡
嵢	嵢
嵣	嵣
嵤	嵤
嵥	嵥
嵦	嵦
嵧	嵧
嵨	嵨
嵩	嵩
嵪	嵪
嵫	嵫
嵬	嵬
嵭	嵭
嵮	嵮
嵯	嵯
嵰	嵰
嵱	嵱
嵲	嵲
嵳	嵳
嵴	嵴
嵵	嵵
嵶	嵶
嵷	嵷
嵸	嵸
嵹	嵹
嵺	嵺
嵻	嵻
嵼	嵼
嵽	嵽
嵾	嵾
嵿	嵿
嶀	嶀
嶁	嵝
嶂	嶂
嶃	嶃
嶄	崭
嶅	嶅
嶆	嶆
嶇	岖
嶈	嶈
嶉	嶉
嶊	嶊
嶋	嶋
嶌	嶌
嶍	嶍
嶎	嶎
嶏	嶏
嶐	嶐
嶑	嶑
嶒	嶒
嶓	嶓
嶔	嵚
嶕	嶕
嶖	嶖
嶗	崂
嶘	嶘
嶙	嶙
嶚	嶚
嶛	嶛
嶜	嶜
嶝	嶝
嶞	嶞
嶟	嶟
嶠	峤
嶡	嶡
嶢	峣
嶣	嶣
嶤	嶤
嶥	嶥
嶦	嶦
嶧	峄
嶨	嶨
嶩	嶩
嶪	嶪
嶫	嶫
嶬	嶬
嶭	嶭
嶮	崄
嶯	嶯
嶰	嶰
嶱	嶱
嶲	嶲
嶳	嶳
嶴	岙
嶵	嶵
嶶	嶶
嶷	嶷
嶸	嵘
嶹	嶹
嶺	岭
嶻	嶻
嶼	屿
嶽	嶽
嶾	嶾
嶿	嶿
巀	巀
巁	巁
巂	巂
巃	巃
巄	巄
巅	巅
巆	巆
巇	巇
巈	巈
巉	巉
巊	巊
巋	岿
巌	巌
巍	巍
巎	巎
巏	巏
巐	巐
巑	巑
巒	峦
巓	巓
巔	巅
巕	巕
巖	巖
巗	巗
巘	巘
巙	巙
巚	巚
巛	巛
巜	巜
川	川
州	州
巟	巟
巠	巠
巡	巡
巢	巢
巣	巣
巤	巤
工	工
左	左
巧	巧
巨	巨
巩	巩
巪	巪
巫	巫
巬	巬
巭	巭
差	差
巯	巯
巰	巯
己	己
已	已
巳	巳
巴	巴
巵	巵
巶	巶
巷	巷
巸	巸
巹	巹
巺	巺
巻	巻
巼	巼
巽	巽
巾	巾
巿	巿
帀	帀
币	币
市	市
布	布
帄	帄
帅	帅
帆	帆
帇	帇
师	师
帉	帉
帊	帊
帋	帋
希	希
帍	帍
帎	帎
帏	帏
帐	帐
帑	帑
帒	帒
帓	帓
帔	帔
帕	帕
帖	帖
帗	帗
帘	帘
帙	帙
帚	帚
帛	帛
帜	帜
帝	帝
帞	帞
帟	帟
帠	帠
帡	帡
帢	帢
帣	帣
帤	帤
帥	帅
带	带
帧	帧
帨	帨
帩	帩
帪	帪
師	师
帬	帬
席	席
帮	帮
帯	帯
帰	帰
帱	帱
帲	帲
帳	帐
帴	帴
帵	帵
帶	带
帷	帷
常	常
帹	帹
帺	帺
帻	帻
帼	帼
帽	帽
帾	帾
帿	帿
幀	帧
幁	幁
幂	幂
幃	帏
幄	幄
幅	幅
幆	幆
幇	幇
幈	幈
幉	幉
幊	幊
幋	幋
幌	幌
幍	幍
幎	幎
幏	幏
幐	幐
幑	幑
幒	幒
幓	幓
幔	幔
幕	幕
幖	幖
幗	帼
幘	帻
幙	幙
幚	幚
幛	幛
幜	幜
幝	幝
幞	幞
幟	帜
幠	幠
幡	幡
幢	幢
幣	币
幤	幤
幥	幥
幦	幦
幧	幧
幨	幨
幩	幩
幪	幪
幫	帮
幬	帱
幭	幭
幮	幮
幯	幯
幰	幰
幱	幱
干	干
平	平
年	年
幵	幵
并	并
幷	幷
幸	幸
幹	干
幺	么
幻	幻
幼	幼
幽	幽
幾	几
广	广
庀	庀
庁	庁
庂	庂
広	広
庄	庄
庅	庅
庆	庆
庇	庇
庈	庈
庉	庉
床	床
庋	庋
庌	庌
庍	庍
庎	庎
序	序
庐	庐
庑	庑
庒	庒
库	库
应	应
底	底
庖	庖
店	店
庘	庘
庙	庙
庚	庚
庛	庛
府	府
庝	庝
庞	庞
废	废
庠	庠
庡	庡
庢	庢
庣	庣
庤	庤
庥	庥
度	度
座	座
庨	庨
庩	庩
庪	庪
庫	库
庬	庬
庭	庭
庮	庮
庯	庯
庰	庰
庱	庱
庲	庲
庳	庳
庴	庴
庵	庵
庶	庶
康	康
庸	庸
庹	庹
庺	庺
庻	庻
庼	庼
庽	庽
庾	庾
庿	庿
廀	廀
廁	厕
廂	厢
廃	廃
廄	厩
廅	廅
廆	廆
廇	廇
廈	厦
廉	廉
廊	廊
廋	廋
廌	廌
廍	廍
廎	廎
廏	廏
廐	廐
廑	廑
廒	廒
廓	廓
廔	廔
廕	廕
廖	廖
廗	廗
廘	廘
廙	廙
廚	厨
廛	廛
廜	廜
廝	厮
廞	廞
廟	庙
廠	厂
廡	庑
廢	废
廣	广
廤	廤
廥	廥
廦	廦
廧	廧
廨	廨
廩	廪
廪	廪
廫	廫
廬	庐
廭	廭
廮	廮
廯	廯
廰	廰
廱	廱
廲	廲
廳	厅
廴	廴
廵	廵
延	延
廷	廷
廸	廸
廹	廹
建	建
廻	廻
廼	廼
廽	廽
廾	廾
廿	廿
开	开
弁	弁
异	异
弃	弃
弄	弄
弅	弅
弆	弆
弇	弇
弈	弈
弉	弉
弊	弊
弋	弋
弌	弌
弍	弍
弎	弎
式	式
弐	弐
弑	弑
弒	弑
弓	弓
弔	弔
引	引
弖	弖
弗	弗
弘	弘
弙	弙
弚	弚
弛	弛
弜	弜
弝	弝
弞	弞
弟	弟
张	张
弡	弡
弢	弢
弣	弣
弤	弤
弥	弥
弦	弦
弧	弧
弨	弨
弩	弩
弪	弪
弫	弫
弬	弬
弭	弭
弮	弮
弯	弯
弰	弰
弱	弱
弲	弲
弳	弪
弴	弴
張	张
弶	弶
強	强
弸	弸
弹	弹
强	强
弻	弻
弼	弼
弽	弽
弾	弾
弿	弿
彀	彀
彁	彁
彂	彂
彃	彃
彄	彄
彅	彅
彆	彆
彇	彇
彈	弹
彉	彉
彊	彊
彋	彋
彌	弥
彍	彍
彎	弯
彏	彏
彐	彐
彑	彑
归	归
当	当
彔	彔
录	录
彖	彖
彗	彗
彘	彘
彙	汇
彚	彚
彛	彛
彜	彜
彝	彝
彞	彝
彟	彟
彠	彟
彡	彡
形	形
彣	彣
彤	彤
彥	彦
彦	彦
彧	彧
彨	彨
彩	彩
彪	彪
彫	彫
彬	彬
彭	彭
彮	彮
彯	彯
彰	彰
影	影
彲	彨
彳	彳
彴	彴
彵	彵
彶	彶
彷	彷
彸	彸
役	役
彺	彺
彻	彻
彼	彼
彽	彽
彾	彾
彿	彿
往	往
征	征
徂	徂
徃	徃
径	径
待	待
徆	徆
徇	徇
很	很
徉	徉
徊	徊
律	律
後	后
徍	徍
徎	徎
徏	徏
徐	徐
徑	径
徒	徒
従	従
徔	徔
徕	徕
徖	徖
得	得
徘	徘
徙	徙
徚	徚
徛	徛
徜	徜
徝	徝
從	从
徟	徟
徠	徕
御	御
徢	徢
徣	徣
徤	徤
徥	徥
徦	徦
徧	徧
徨	徨
復	复
循	循
徫	徫
徬	徬
徭	徭
微	微
徯	徯
徰	徰
徱	徱
徲	徲
徳	徳
徴	徴
徵	徵
徶	徶
德	德
徸	徸
徹	彻
徺	徺
徻	徻
徼	徼
徽	徽
徾	徾
徿	徿
忀	忀
忁	忁
忂	忂
心	心
忄	忄
必	必
忆	忆
忇	忇
忈	忈
忉	忉
忊	忊
忋	忋
忌	忌
忍	忍
忎	忎
忏	忏
忐	忐
忑	忑
忒	忒
忓	忓
忔	忔
忕	忕
忖	忖
志	志
忘	忘
忙	忙
忚	忚
忛	忛
応	応
忝	忝
忞	忞
忟	忟
忠	忠
忡	忡
忢	忢
忣	忣
忤	忤
忥	忥
忦	忦
忧	忧
忨	忨
忩	忩
忪	忪
快	快
忬	忬
忭	忭
忮	忮
忯	忯
忰	忰
忱	忱
忲	忲
忳	忳
忴	忴
念	念
忶	忶
忷	忷
忸	忸
忹	忹
忺	忺
忻	忻
忼	忼
忽	忽
忾	忾
忿	忿
怀	怀
态	态
怂	怂
怃	怃
怄	怄
怅	怅
怆	怆
怇	怇
怈	怈
怉	怉
怊	怊
怋	怋
怌	怌
怍	怍
怎	怎
怏	怏
怐	怐
怑	怑
怒	怒
怓	怓
怔	怔
怕	怕
怖	怖
怗	怗
怘	怘
怙	怙
怚	怚
怛	怛
怜	怜
思	思
怞	怞
怟	怟
怠	怠
怡	怡
怢	怢
怣	怣
怤	怤
急	急
怦	怦
性	性
怨	怨
怩	怩
怪	怪
怫	怫
怬	怬
怭	怭
怮	怮
怯	怯
怰	怰
怱	怱
怲	怲
怳	怳
怴	怴
怵	怵
怶	怶
怷	怷
怸	怸
怹	怹
怺	怺
总	总
怼	怼
怽	怽
怾	怾
怿	怿
恀	恀
恁	恁
恂	恂
恃	恃
恄	恄
恅	恅
恆	恒
恇	恇
恈	恈
恉	恉
恊	恊
恋	恋
恌	恌
恍	恍
恎	恎
恏	恏
恐	恐
恑	恑
恒	恒
恓	恓
恔	恔
恕	恕
恖	恖
恗	恗
恘	恘
恙	恙
恚	恚
恛	恛
恜	恜
恝	恝
恞	恞
恟	恟
恠	恠
恡	恡
恢	恢
恣	恣
恤	恤
恥	耻
恦	恦
恧	恧
恨	恨
恩	恩
恪	恪
恫	恫
恬	恬
恭	恭
恮	恮
息	息
恰	恰
恱	恱
恲	恲
恳	恳
恴	恴
恵	恵
恶	恶
恷	恷
恸	恸
恹	恹
恺	恺
恻	恻
恼	恼
恽	恽
恾	恾
恿	恿
悀	悀
悁	悁
悂	悂
悃	悃
悄	悄
悅	悦
悆	悆
悇	悇
悈	悈
悉	悉
悊	悊
悋	悋
悌	悌
悍	悍
悎	悎
悏	悏
悐	悐
悑	悑
悒	悒
悓	悓
悔	悔
悕	悕
悖	悖
悗	悗
悘	悘
悙	悙
悚	悚
悛	悛
悜	悜
悝	悝
悞	悮
悟	悟
悠	悠
悡	悡
悢	悢
患	患
悤	悤
悥	悥
悦	悦
悧	悧
您	您
悩	悩
悪	悪
悫	悫
悬	悬
悭	悭
悮	悮
悯	悯
悰	悰
悱	悱
悲	悲
悳	悳
悴	悴
悵	怅
悶	闷
悷	悷
悸	悸
悹	悹
悺	悺
悻	悻
悼	悼
悽	悽
悾	悾
悿	悿
惀	惀
惁	惁
惂	惂
惃	惃
惄	惄
情	情
惆	惆
惇	惇
惈	惈
惉	惉
惊	惊
惋	惋
惌	惌
惍	惍
惎	惎
惏	惏
惐	惐
惑	惑
惒	惒
惓	惓
惔	惔
惕	惕
惖	惖
惗	惗
惘	惘
惙	惙
惚	惚
惛	惛
惜	惜
惝	惝
惞	惞
惟	惟
惠	惠
惡	恶
惢	惢
惣	惣
惤	惤
惥	惥
惦	惦
惧	惧
惨	惨
惩	惩
惪	惪
惫	惫
惬	惬
惭	惭
惮	惮
惯	惯
惰	惰
惱	恼
惲	恽
想	想
惴	惴
惵	惵
惶	惶
惷	惷
惸	惸
惹	惹
惺	惺
惻	恻
惼	惼
惽	惽
惾	惾
惿	惿
愀	愀
愁	愁
愂	愂
愃	愃
愄	愄
愅	愅
愆	愆
愇	愇
愈	愈
愉	愉
愊	愊
愋	愋
愌	愌
愍	愍
愎	愎
意	意
愐	愐
愑	愑
愒	愒
愓	愓
愔	愔
愕	愕
愖	愖
愗	愗
愘	愘
愙	愙
愚	愚
愛	爱
愜	惬
愝	愝
愞	愞
感	感
愠	愠
愡	愡
愢	愢
愣	愣
愤	愤
愥	愥
愦	愦
愧	愧
愨	悫
愩	愩
愪	愪
愫	愫
愬	愬
愭	愭
愮	愮
愯	愯
愰	愰
愱	愱
愲	愲
愳	愳
愴	怆
愵	愵
愶	愶
愷	恺
愸	愸
愹	愹
愺	愺
愻	愻
愼	愼
愽	愽
愾	忾
愿	愿
慀	慀
慁	慁
慂	慂
慃	慃
慄	栗
慅	慅
慆	慆
慇	慇
慈	慈
慉	慉
慊	慊
態	态
慌	慌
慍	愠
慎	慎
慏	慏
慐	慐
慑	慑
慒	慒
慓	慓
慔	慔
慕	慕
慖	慖
慗	慗
慘	惨
慙	慙
慚	惭
慛	慛
慜	慜
慝	慝
慞	慞
慟	恸
慠	慠
慡	慡
慢	慢
慣	惯
慤	慤
慥	慥
慦	慦
慧	慧
慨	慨
慩	慩
慪	怄
慫	怂
慬	慬
慭	慭
慮	虑
慯	慯
慰	慰
慱	慱
慲	慲
慳	悭
慴	慴
慵	慵
慶	庆
慷	慷
慸	慸
慹	慹
慺	慺
慻	慻
慼	慼
慽	慽
慾	慾
慿	慿
憀	憀
憁	憁
憂	忧
憃	憃
憄	憄
憅	憅
憆	憆
憇	憇
憈	憈
憉	憉
憊	惫
憋	憋
憌	憌
憍	憍
憎	憎
憏	憏
憐	怜
憑	凭
憒	愦
憓	憓
憔	憔
憕	憕
憖	憖
憗	憗
憘	憘
憙	憙
憚	惮
憛	憛
憜	憜
憝	憝
憞	憞
憟	憟
憠	憠
憡	憡
憢	憢
憣	憣
憤	愤
憥	憥
憦	憦
憧	憧
憨	憨
憩	憩
憪	憪
憫	悯
憬	憬
憭	憭
憮	怃
憯	憯
憰	憰
憱	憱
憲	宪
憳	憳
憴	憴
憵	憵
憶	忆
憷	憷
憸	憸
憹	憹
憺	憺
憻	憻
憼	憼
憽	憽
憾	憾
憿	憿
懀	懀
懁	懁
懂	懂
懃	懃
懄	懄
懅	懅
懆	懆
懇	恳
懈	懈
應	应
懊	懊
懋	懋
懌	怿
懍	懔
懎	懎
懏	懏
懐	懐
懑	懑
懒	懒
懓	懓
懔	懔
懕	懕
懖	懖
懗	懗
懘	懘
懙	懙
懚	懚
懛	懛
懜	懜
懝	懝
懞	懞
懟	怼
懠	懠
懡	懡
懢	懢
懣	懑
懤	懤
懥	懥
懦	懦
懧	懧
懨	恹
懩	懩
懪	懪
懫	懫
懬	懬
懭	懭
懮	懮
懯	懯
懰	懰
懱	懱
懲	惩
懳	懳
懴	懴
懵	懵
懶	懒
懷	怀
懸	悬
懹	懹
懺	忏
懻	懻
懼	惧
懽	懽
懾	慑
懿	懿
戀	恋
戁	戁
戂	戂
戃	戃
戄	戄
戅	戅
戆	戆
戇	戆
戈	戈
戉	戉
戊	戊
戋	戋
戌	戌
戍	戍
戎	戎
戏	戏
成	成
我	我
戒	戒
戓	戓
戔	戋
戕	戕
或	或
戗	戗
战	战
戙	戙
戚	戚
戛	戛
戜	戜
戝	戝
戞	戞
戟	戟
戠	戠
戡	戡
戢	戢
戣	戣
戤	戤
戥	戥
戦	戦
戧	戗
戨	戨
戩	戬
截	截
戫	戫
戬	戬
戭	戭
戮	戮
戯	戯
戰	战
戱	戯
戲	戏
戳	戳
戴	戴
戵	戵
戶	户
户	户
戸	戸
戹	戹
戺	戺
戻	戻
戼	戼
戽	戽
戾	戾
房	房
所	所
扁	扁
扂	扂
扃	扃
扄	扄
扅	扅
扆	扆
扇	扇
扈	扈
扉	扉
扊	扊
手	手
扌	扌
才	才
扎	扎
扏	扏
扐	扐
扑	扑
扒	扒
打	打
扔	扔
払	払
扖	扖
扗	扗
托	托
扙	扙
扚	扚
扛	扛
扜	扜
扝	扝
扞	扞
扟	扟
扠	扠
扡	扡
扢	扢
扣	扣
扤	扤
扥	扥
扦	扦
执	执
扨	扨
扩	扩
扪	扪
扫	扫
扬	扬
扭	扭
扮	扮
扯	扯
扰	扰
扱	扱
扲	扲
扳	扳
扴	扴
扵	扵
扶	扶
扷	扷
扸	扸
批	批
扺	扺
扻	扻
扼	扼
扽	扽
找	找
承	承
技	技
抁	抁
抂	抂
抃	抃
抄	抄
抅	抅
抆	抆
抇	抇
抈	抈
抉	抉
把	把
抋	抋
抌	抌
抍	抍
抎	抎
抏	抏
抐	抐
抑	抑
抒	抒
抓	抓
抔	抔
投	投
抖	抖
抗	抗
折	折
抙	抙
抚	抚
抛	抛
抜	抜
抝	抝
択	択
抟	抟
抠	抠
抡	抡
抢	抢
抣	抣
护	护
报	报
抦	抦
抧	抧
抨	抨
抩	抩
抪	抪
披	披
抬	抬
抭	抭
抮	抮
抯	抯
抰	抰
抱	抱
抲	抲
抳	抳
抴	抴
抵	抵
抶	抶
抷	抷
抸	抸
抹	抹
抺	抺
抻	抻
押	押
抽	抽
抾	抾
抿	抿
拀	拀
拁	拁
拂	拂
拃	拃
拄	拄
担	担
拆	拆
拇	拇
拈	拈
拉	拉
拊	拊
拋	抛
拌	拌
拍	拍
拎	拎
拏	拏
拐	拐
拑	拑
拒	拒
拓	拓
拔	拔
拕	拕
拖	拖
拗	拗
拘	拘
拙	拙
拚	拚
招	招
拜	拜
拝	拝
拞	拞
拟	拟
拠	拠
拡	拡
拢	拢
拣	拣
拤	拤
拥	拥
拦	拦
拧	拧
拨	拨
择	择
拪	拪
拫	拫
括	括
拭	拭
拮	拮
拯	拯
拰	拰
拱	拱
拲	拲
拳	拳
拴	拴
拵	拵
拶	拶
拷	拷
拸	拸
拹	拹
拺	拺
拻	拻
拼	拼
拽	拽
拾	拾
拿	拿
挀	挀
持	持
挂	挂
挃	挃
挄	挄
挅	挅
挆	挆
指	指
挈	挈
按	按
挊	挊
挋	挋
挌	挌
挍	挍
挎	挎
挏	挏
挐	挐
挑	挑
挒	挒
挓	挓
挔	挔
挕	挕
挖	挖
挗	挗
挘	挘
挙	挙
挚	挚
挛	挛
挜	挜
挝	挝
挞	挞
挟	挟
挠	挠
挡	挡
挢	挢
挣	挣
挤	挤
挥	挥
挦	挦
挧	挧
挨	挨
挩	捝
挪	挪
挫	挫
挬	挬
挭	挭
挮	挮
振	振
挰	挰
挱	挱
挲	挲
挳	挳
挴	挴
挵	挵
挶	挶
挷	挷
挸	挸
挹	挹
挺	挺
挻	挻
挼	挼
挽	挽
挾	挟
挿	挿
捀	捀
捁	捁
捂	捂
捃	捃
捄	捄
捅	捅
捆	捆
捇	捇
捈	捈
捉	捉
捊	捊
捋	捋
捌	捌
捍	捍
捎	捎
捏	捏
捐	捐
捑	捑
捒	捒
捓	捓
捔	捔
捕	捕
捖	捖
捗	捗
捘	捘
捙	捙
捚	捚
捛	捛
捜	捜
捝	捝
捞	捞
损	损
捠	捠
捡	捡
换	换
捣	捣
捤	捤
捥	捥
捦	捦
捧	捧
捨	舍
捩	捩
捪	捪
捫	扪
捬	捬
捭	捭
据	据
捯	捯
捰	捰
捱	捱
捲	捲
捳	捳
捴	捴
捵	捵
捶	捶
捷	捷
捸	捸
捹	捹
捺	捺
捻	捻
捼	捼
捽	捽
捾	捾
捿	捿
掀	掀
掁	掁
掂	掂
掃	扫
掄	抡
掅	掅
掆	掆
掇	掇
授	授
掉	掉
掊	掊
掋	掋
掌	掌
掍	掍
掎	掎
掏	掏
掐	掐
掑	掑
排	排
掓	掓
掔	掔
掕	掕
掖	掖
掗	挜
掘	掘
掙	挣
掚	掚
掛	挂
掜	掜
掝	掝
掞	掞
掟	掟
掠	掠
採	采
探	探
掣	掣
掤	掤
接	接
掦	掦
控	控
推	推
掩	掩
措	措
掫	掫
掬	掬
掭	掭
掮	掮
掯	掯
掰	掰
掱	掱
掲	掲
掳	掳
掴	掴
掵	掵
掶	掶
掷	掷
掸	掸
掹	掹
掺	掺
掻	掻
掼	掼
掽	掽
掾	掾
掿	掿
揀	拣
揁	揁
揂	揂
揃	揃
揄	揄
揅	揅
揆	揆
揇	揇
揈	揈
揉	揉
揊	揊
揋	揋
揌	揌
揍	揍
揎	揎
描	描
提	提
揑	揑
插	插
揓	揓
揔	揔
揕	揕
揖	揖
揗	揗
揘	揘
揙	揙
揚	扬
換	换
揜	揜
揝	揝
揞	揞
揟	揟
揠	揠
握	握
揢	揢
揣	揣
揤	揤
揥	揥
揦	揦
揧	揧
揨	揨
揩	揩
揪	揪
揫	揫
揬	揬
揭	揭
揮	挥
揯	揯
揰	揰
揱	揱
揲	揲
揳	揳
援	援
揵	揵
揶	揶
揷	揷
揸	揸
揹	揹
揺	揺
揻	揻
揼	揼
揽	揽
揾	揾
揿	揿
搀	搀
搁	搁
搂	搂
搃	搃
搄	搄
搅	搅
搆	搆
搇	搇
搈	搈
搉	搉
搊	搊
搋	搋
搌	搌
損	损
搎	搎
搏	搏
搐	搐
搑	搑
搒	搒
搓	搓
搔	搔
搕	搕
搖	摇
搗	捣
搘	搘
搙	搙
搚	搚
搛	搛
搜	搜
搝	搝
搞	搞
搟	搟
搠	搠
搡	搡
搢	搢
搣	搣
搤	搤
搥	搥
搦	搦
搧	搧
搨	搨
搩	搩
搪	搪
搫	搫
搬	搬
搭	搭
搮	搮
搯	搯
搰	搰
搱	搱
搲	搲
搳	搳
搴	搴
搵	揾
搶	抢
搷	搷
搸	搸
搹	搹
携	携
搻	搻
搼	搼
搽	搽
搾	搾
搿	搿
摀	摀
摁	摁
摂	摂
摃	摃
摄	摄
摅	摅
摆	摆
摇	摇
摈	摈
摉	摉
摊	摊
摋	摋
摌	摌
摍	摍
摎	摎
摏	摏
摐	摐
摑	掴
摒	摒
摓	摓
摔	摔
摕	摕
摖	摖
摗	摗
摘	摘
摙	摙
摚	摚
摛	摛
摜	掼
摝	摝
摞	摞
摟	搂
摠	摠
摡	摡
摢	摢
摣	摣
摤	摤
摥	摥
摦	摦
摧	摧
摨	摨
摩	摩
摪	摪
摫	摫
摬	摬
摭	摭
摮	摮
摯	挚
摰	摰
摱	摱
摲	摲
摳	抠
摴	摴
摵	摵
摶	抟
摷	摷
摸	摸
摹	摹
摺	摺
摻	掺
摼	摼
摽	摽
摾	摾
摿	摿
撀	撀
撁	撁
撂	撂
撃	撃
撄	撄
撅	撅
撆	撆
撇	撇
撈	捞
撉	撉
撊	撊
撋	撋
撌	撌
撍	撍
撎	撎
撏	挦
撐	撑
撑	撑
撒	撒
撓	挠
撔	撔
撕	撕
撖	撖
撗	撗
撘	撘
撙	撙
撚	撚
撛	撛
撜	撜
撝	撝
撞	撞
撟	挢
撠	撠
撡	撡
撢	撢
撣	掸
撤	撤
撥	拨
撦	撦
撧	撧
撨	撨
撩	撩
撪	撪
撫	抚
撬	撬
播	播
撮	撮
撯	撯
撰	撰
撱	撱
撲	扑
撳	揿
撴	撴
撵	撵
撶	撶
撷	撷
撸	撸
撹	撹
撺	撺
撻	挞
撼	撼
撽	撽
撾	挝
撿	捡
擀	擀
擁	拥
擂	擂
擃	擃
擄	掳
擅	擅
擆	擆
擇	择
擈	擈
擉	擉
擊	击
擋	挡
擌	擌
操	操
擎	擎
擏	擏
擐	擐
擑	擑
擒	擒
擓	擓
擔	担
擕	擕
擖	擖
擗	擗
擘	擘
擙	擙
據	据
擛	擛
擜	擜
擝	擝
擞	擞
擟	擟
擠	挤
擡	擡
擢	擢
擣	擣
擤	擤
擥	擥
擦	擦
擧	擧
擨	擨
擩	擩
擪	擪
擫	擫
擬	拟
擭	擭
擮	擮
擯	摈
擰	拧
擱	搁
擲	掷
擳	擳
擴	扩
擵	擵
擶	擶
擷	撷
擸	擸
擹	擹
擺	摆
擻	擞
擼	撸
擽	擽
擾	扰
擿	擿
攀	攀
攁	攁
攂	攂
攃	攃
攄	摅
攅	攅
攆	撵
攇	攇
攈	攈
攉	攉
攊	攊
攋	攋
攌	攌
攍	攍
攎	攎
攏	拢
攐	攐
攑	攑
攒	攒
攓	攓
攔	拦
攕	攕
攖	撄
攗	攗
攘	攘
攙	搀
攚	攚
攛	撺
攜	携
攝	摄
攞	攞
攟	攟
攠	攠
攡	攡
攢	攒
攣	挛
攤	摊
攥	攥
攦	攦
攧	攧
攨	攨
攩	攩
攪	搅
攫	攫
攬	揽
攭	攭
攮	攮
支	支
攰	攰
攱	攱
攲	攲
攳	攳
攴	攴
攵	攵
收	收
攷	攷
攸	攸
改	改
攺	攺
攻	攻
攼	攼
攽	攽
放	放
政	政
敀	敀
敁	敁
敂	敂
敃	敃
敄	敄
故	故
敆	敆
敇	敇
效	效
敉	敉
敊	敊
敋	敋
敌	敌
敍	敍
敎	敎
敏	敏
敐	敐
救	救
敒	敒
敓	敓
敔	敔
敕	敕
敖	敖
敗	败
敘	叙
教	教
敚	敚
敛	敛
敜	敜
敝	敝
敞	敞
敟	敟
敠	敠
敡	敡
敢	敢
散	散
敤	敤
敥	敥
敦	敦
敧	敧
敨	敨
敩	敩
敪	敪
敫	敫
敬	敬
敭	敭
敮	敮
敯	敯
数	数
敱	敱
敲	敲
敳	敳
整	整
敵	敌
敶	敶
敷	敷
數	数
敹	敹
敺	敺
敻	敻
敼	敼
敽	敽
敾	敾
敿	敿
斀	斀
斁	斁
斂	敛
斃	毙
斄	斄
斅	斅
斆	敩
文	文
斈	斈
斉	斉
斊	斊
斋	斋
斌	斌
斍	斍
斎	斎
斏	斏
斐	斐
斑	斑
斒	斒
斓	斓
斔	斔
斕	斓
斖	斖
斗	斗
斘	斘
料	料
斚	斚
斛	斛
斜	斜
斝	斝
斞	斞
斟	斟
斠	斠
斡	斡
斢	斢
斣	斣
斤	斤
斥	斥
斦	斦
斧	斧
斨	斨
斩	斩
斪	斪
斫	斫
斬	斩
断	断
斮	斮
斯	斯
新	新
斱	斱
斲	斲
斳	斳
斴	斴
斵	斵
斶	斶
斷	断
斸	斸
方	方
斺	斺
斻	斻
於	于
施	施
斾	斾
斿	斿
旀	旀
旁	旁
旂	旂
旃	旃
旄	旄
旅	旅
旆	旆
旇	旇
旈	旈
旉	旉
旊	旊
旋	旋
旌	旌
旍	旍
旎	旎
族	族
旐	旐
旑	旑
旒	旒
旓	旓
旔	旔
旕	旕
旖	旖
旗	旗
旘	旘
旙	旙
旚	旚
旛	旛
旜	旜
旝	旝
旞	旞
旟	旟
无	无
旡	旡
既	既
旣	旣
旤	旤
日	日
旦	旦
旧	旧
旨	旨
早	早
旪	旪
旫	旫
旬	旬
旭	旭
旮	旮
旯	旯
旰	旰
旱	旱
旲	旲
旳	旳
旴	旴
旵	旵
时	时
旷	旷
旸	旸
旹	旹
旺	旺
旻	旻
旼	旼
旽	旽
旾	旾
旿	旿
昀	昀
昁	昁
昂	昂
昃	昃
昄	昄
昅	昅
昆	昆
昇	昇
昈	昈
昉	昉
昊	昊
昋	昋
昌	昌
昍	昍
明	明
昏	昏
昐	昐
昑	昑
昒	昒
易	易
昔	昔
昕	昕
昖	昖
昗	昗
昘	昘
昙	昙
昚	昚
昛	昛
昜	昜
昝	昝
昞	昞
星	星
映	映
昡	昡
昢	昢
昣	昣
昤	昤
春	春
昦	昦
昧	昧
昨	昨
昩	昩
昪	昪
昫	昫
昬	昬
昭	昭
昮	昮
是	是
昰	昰
昱	昱
昲	昲
昳	昳
昴	昴
昵	昵
昶	昶
昷	昷
昸	昸
昹	昹
昺	昺
昻	昻
昼	昼
昽	昽
显	显
昿	昿
晀	晀
晁	晁
時	时
晃	晃
晄	晄
晅	晅
晆	晆
晇	晇
晈	晈
晉	晋
晊	晊
晋	晋
晌	晌
晍	晍
晎	晎
晏	晏
晐	晐
晑	晑
晒	晒
晓	晓
晔	晔
晕	晕
晖	晖
晗	晗
晘	晘
晙	晙
晚	晚
晛	晛
晜	晜
晝	昼
晞	晞
晟	晟
晠	晠
晡	晡
晢	晢
晣	晣
晤	晤
晥	晥
晦	晦
晧	晧
晨	晨
晩	晩
晪	晪
晫	晫
晬	晬
晭	晭
普	普
景	景
晰	晰
晱	晱
晲	晲
晳	晳
晴	晴
晵	晵
晶	晶
晷	晷
晸	晸
晹	晹
智	智
晻	晻
晼	晼
晽	晽
晾	晾
晿	晿
暀	暀
暁	暁
暂	暂
暃	暃
暄	暄
暅	暅
暆	暆
暇	暇
暈	晕
暉	晖
暊	暊
暋	暋
暌	暌
暍	暍
暎	暎
暏	暏
暐	暐
暑	暑
暒	暒
暓	暓
暔	暔
暕	暕
暖	暖
暗	暗
暘	旸
暙	暙
暚	暚
暛	暛
暜	暜
暝	暝
暞	暞
暟	暟
暠	暠
暡	暡
暢	畅
暣	暣
暤	暤
暥	暥
暦	暦
暧	暧
暨	暨
暩	暩
暪	暪
暫	暂
暬	暬
暭	暭
暮	暮
暯	暯
暰	暰
暱	暱
暲	暲
暳	暳
暴	暴
暵	暵
暶	暶
暷	暷
暸	暸
暹	暹
暺	暺
暻	暻
暼	暼
暽	暽
暾	暾
暿	暿
曀	曀
曁	曁
曂	曂
曃	曃
曄	晔
曅	曅
曆	历
曇	昙
曈	曈
曉	晓
曊	曊
曋	曋
曌	曌
曍	曍
曎	曎
曏	向
曐	曐
曑	曑
曒	曒
曓	曓
曔	曔
曕	曕
曖	暧
曗	曗
曘	曘
曙	曙
曚	曚
曛	曛
曜	曜
曝	曝
曞	曞
曟	曟
曠	旷
曡	曡
曢	曢
曣	曣
曤	曤
曥	曥
曦	曦
曧	曧
曨	昽
曩	曩
曪	曪
曫	曫
曬	晒
曭	曭
曮	曮
曯	曯
曰	曰
曱	曱
曲	曲
曳	曳
更	更
曵	曵
曶	曶
曷	曷
書	书
曹	曹
曺	曺
曻	曻
曼	曼
曽	曽
曾	曾
替	替
最	最
朁	朁
朂	朂
會	会
朄	朄
朅	朅
朆	朆
朇	朇
月	月
有	有
朊	朊
朋	朋
朌	朌
服	服
朎	朎
朏	朏
朐	朐
朑	朑
朒	朒
朓	朓
朔	朔
朕	朕
朖	朖
朗	朗
朘	朘
朙	朙
朚	朚
望	望
朜	朜
朝	朝
朞	朞
期	期
朠	朠
朡	朡
朢	朢
朣	朣
朤	朤
朥	朥
朦	朦
朧	胧
木	木
朩	朩
未	未
末	末
本	本
札	札
朮	朮
术	术
朰	朰
朱	朱
朲	朲
朳	朳
朴	朴
朵	朵
朶	朶
朷	朷
朸	朸
朹	朹
机	机
朻	朻
朼	朼
朽	朽
朾	朾
朿	朿
杀	杀
杁	杁
杂	杂
权	权
杄	杄
杅	杅
杆	杆
杇	杇
杈	杈
杉	杉
杊	杊
杋	杋
杌	杌
杍	杍
李	李
杏	杏
材	材
村	村
杒	杒
杓	杓
杔	杔
杕	杕
杖	杖
杗	杗
杘	杘
杙	杙
杚	杚
杛	杛
杜	杜
杝	杝
杞	杞
束	束
杠	杠
条	条
杢	杢
杣	杣
杤	杤
来	来
杦	杦
杧	杧
杨	杨
杩	杩
杪	杪
杫	杫
杬	杬
杭	杭
杮	杮
杯	杯
杰	杰
東	东
杲	杲
杳	杳
杴	锨
杵	杵
杶	杶
杷	杷
杸	杸
杹	杹
杺	杺
杻	杻
杼	杼
杽	杽
松	松
板	板
枀	枀
极	极
枂	枂
枃	枃
构	构
枅	枅
枆	枆
枇	枇
枈	枈
枉	枉
枊	枊
枋	枋
枌	枌
枍	枍
枎	枎
枏	枏
析	析
枑	枑
枒	枒
枓	枓
枔	枔
枕	枕
枖	枖
林	林
枘	枘
枙	枙
枚	枚
枛	枛
果	果
枝	枝
枞	枞
枟	枟
枠	枠
枡	枡
枢	枢
枣	枣
枤	枤
枥	枥
枦	枦
枧	枧
枨	枨
枩	枩
枪	枪
枫	枫
枬	枬
枭	枭
枮	枮
枯	枯
枰	枰
枱	枱
枲	枲
枳	枳
枴	枴
枵	枵
架	架
枷	枷
枸	枸
枹	枹
枺	枺
枻	枻
枼	枼
枽	枽
枾	枾
枿	枿
柀	柀
柁	柁
柂	柂
柃	柃
柄	柄
柅	柅
柆	柆
柇	柇
柈	柈
柉	柉
柊	柊
柋	柋
柌	柌
柍	柍
柎	柎
柏	柏
某	某
柑	柑
柒	柒
染	染
柔	柔
柕	柕
柖	柖
柗	柗
柘	柘
柙	柙
柚	柚
柛	柛
柜	柜
柝	柝
柞	柞
柟	柟
柠	柠
柡	柡
柢	柢
柣	柣
柤	柤
查	查
柦	柦
柧	柧
柨	柨
柩	柩
柪	柪
柫	柫
柬	柬
柭	柭
柮	柮
柯	柯
柰	柰
柱	柱
柲	柲
柳	柳
柴	柴
柵	栅
柶	柶
柷	柷
柸	柸
柹	柹
柺	柺
査	査
柼	柼
柽	柽
柾	柾
柿	柿
栀	栀
栁	栁
栂	栂
栃	栃
栄	栄
栅	栅
栆	栆
标	标
栈	栈
栉	栉
栊	栊
栋	栋
栌	栌
栍	栍
栎	栎
栏	栏
栐	栐
树	树
栒	栒
栓	栓
栔	栔
栕	栕
栖	栖
栗	栗
栘	栘
栙	栙
栚	栚
栛	栛
栜	栜
栝	栝
栞	栞
栟	栟
栠	栠
校	校
栢	栢
栣	栣
栤	栤
栥	栥
栦	栦
栧	栧
栨	栨
栩	栩
株	株
栫	栫
栬	栬
栭	栭
栮	栮
栯	栯
栰	栰
栱	栱
栲	栲
栳	栳
栴	栴
栵	栵
栶	栶
样	样
核	核
根	根
栺	栺
栻	栻
格	格
栽	栽
栾	栾
栿	栿
桀	桀
桁	桁
桂	桂
桃	桃
桄	桄
桅	桅
框	框
桇	桇
案	案
桉	桉
桊	桊
桋	桋
桌	桌
桍	桍
桎	桎
桏	桏
桐	桐
桑	桑
桒	桒
桓	桓
桔	桔
桕	桕
桖	桖
桗	桗
桘	桘
桙	桙
桚	桚
桛	桛
桜	桜
桝	桝
桞	桞
桟	桟
桠	桠
桡	桡
桢	桢
档	档
桤	桤
桥	桥
桦	桦
桧	桧
桨	桨
桩	桩
桪	桪
桫	桫
桬	桬
桭	桭
桮	桮
桯	桯
桰	桰
桱	桱
桲	桲
桳	桳
桴	桴
桵	桵
桶	桶
桷	桷
桸	桸
桹	桹
桺	桺
桻	桻
桼	桼
桽	桽
桾	桾
桿	杆
梀	梀
梁	梁
梂	梂
梃	梃
梄	梄
梅	梅
梆	梆
梇	梇
梈	梈
梉	梉
梊	梊
梋	梋
梌	梌
梍	梍
梎	梎
梏	梏
梐	梐
梑	梑
梒	梒
梓	梓
梔	栀
梕	梕
梖	梖
梗	梗
梘	枧
梙	梙
梚	梚
梛	梛
梜	梜
條	条
梞	梞
梟	枭
梠	梠
梡	梡
梢	梢
梣	梣
梤	梤
梥	梥
梦	梦
梧	梧
梨	梨
梩	梩
梪	梪
梫	梫
梬	梬
梭	梭
梮	梮
梯	梯
械	械
梱	梱
梲	棁
梳	梳
梴	梴
梵	梵
梶	梶
梷	梷
梸	梸
梹	梹
梺	梺
梻	梻
梼	梼
梽	梽
梾	梾
梿	梿
检	检
棁	棁
棂	棂
棃	棃
棄	弃
棅	棅
棆	棆
棇	棇
棈	棈
棉	棉
棊	棊
棋	棋
棌	棌
棍	棍
棎	棎
棏	棏
棐	棐
棑	棑
棒	棒
棓	棓
棔	棔
棕	棕
棖	枨
棗	枣
棘	棘
棙	棙
棚	棚
棛	棛
棜	棜
棝	棝
棞	棞
棟	栋
棠	棠
棡	棡
棢	棢
棣	棣
棤	棤
棥	棥
棦	棦
棧	栈
棨	棨
棩	棩
棪	棪
棫	棫
棬	棬
棭	棭
森	森
棯	棯
棰	棰
棱	棱
棲	栖
棳	棳
棴	棴
棵	棵
棶	梾
棷	棷
棸	棸
棹	棹
棺	棺
棻	棻
棼	棼
棽	棽
棾	棾
棿	棿
椀	椀
椁	椁
椂	椂
椃	椃
椄	椄
椅	椅
椆	椆
椇	椇
椈	椈
椉	椉
椊	椊
椋	椋
椌	椌
植	植
椎	椎
椏	桠
椐	椐
椑	椑
椒	椒
椓	椓
椔	椔
椕	椕
椖	椖
椗	椗
椘	椘
椙	椙
椚	椚
椛	椛
検	検
椝	椝
椞	椞
椟	椟
椠	椠
椡	椡
椢	椢
椣	椣
椤	椤
椥	椥
椦	椦
椧	椧
椨	椨
椩	椩
椪	椪
椫	椫
椬	椬
椭	椭
椮	椮
椯	椯
椰	椰
椱	椱
椲	椲
椳	椳
椴	椴
椵	椵
椶	椶
椷	椷
椸	椸
椹	椹
椺	椺
椻	椻
椼	椼
椽	椽
椾	椾
椿	椿
楀	楀
楁	楁
楂	楂
楃	楃
楄	楄
楅	楅
楆	楆
楇	楇
楈	楈
楉	楉
楊	杨
楋	楋
楌	楌
楍	楍
楎	楎
楏	楏
楐	楐
楑	楑
楒	楒
楓	枫
楔	楔
楕	楕
楖	楖
楗	楗
楘	楘
楙	楙
楚	楚
楛	楛
楜	楜
楝	楝
楞	楞
楟	楟
楠	楠
楡	楡
楢	楢
楣	楣
楤	楤
楥	楥
楦	楦
楧	楧
楨	桢
楩	楩
楪	楪
楫	楫
楬	楬
業	业
楮	楮
楯	楯
楰	楰
楱	楱
楲	楲
楳	楳
楴	楴
極	极
楶	楶
楷	楷
楸	楸
楹	楹
楺	楺
楻	楻
楼	楼
楽	楽
楾	楾
楿	楿
榀	榀
榁	榁
概	概
榃	榃
榄	榄
榅	榅
榆	榆
榇	榇
榈	榈
榉	榉
榊	榊
榋	榋
榌	榌
榍	榍
榎	榎
榏	榏
榐	榐
榑	榑
榒	榒
榓	榓
榔	榔
榕	榕
榖	榖
榗	榗
榘	榘
榙	榙
榚	榚
榛	榛
榜	榜
榝	榝
榞	榞
榟	榟
榠	榠
榡	榡
榢	榢
榣	榣
榤	榤
榥	榥
榦	榦
榧	榧
榨	榨
榩	榩
榪	杩
榫	榫
榬	榬
榭	榭
榮	荣
榯	榯
榰	榰
榱	榱
榲	榅
榳	榳
榴	榴
榵	榵
榶	榶
榷	榷
榸	榸
榹	榹
榺	榺
榻	榻
榼	榼
榽	榽
榾	榾
榿	桤
槀	槀
槁	槁
槂	槂
槃	槃
槄	槄
槅	槅
槆	槆
槇	槇
槈	槈
槉	槉
槊	槊
構	构
槌	槌
槍	枪
槎	槎
槏	槏
槐	槐
槑	槑
槒	槒
槓	槓
槔	槔
槕	槕
槖	槖
槗	槗
様	様
槙	槙
槚	槚
槛	槛
槜	槜
槝	槝
槞	槞
槟	槟
槠	槠
槡	槡
槢	槢
槣	槣
槤	梿
槥	槥
槦	槦
槧	椠
槨	椁
槩	槩
槪	槪
槫	槫
槬	槬
槭	槭
槮	槮
槯	槯
槰	槰
槱	槱
槲	槲
槳	桨
槴	槴
槵	槵
槶	椢
槷	槷
槸	槸
槹	槹
槺	槺
槻	槻
槼	椝
槽	槽
槾	槾
槿	槿
樀	樀
樁	桩
樂	乐
樃	樃
樄	樄
樅	枞
樆	樆
樇	樇
樈	樈
樉	樉
樊	樊
樋	樋
樌	樌
樍	樍
樎	樎
樏	樏
樐	樐
樑	樑
樒	樒
樓	楼
樔	樔
樕	樕
樖	樖
樗	樗
樘	樘
標	标
樚	樚
樛	樛
樜	樜
樝	樝
樞	枢
樟	樟
樠	樠
模	模
樢	樢
樣	样
樤	樤
樥	樥
樦	樦
樧	樧
樨	樨
権	権
横	横
樫	樫
樬	樬
樭	樭
樮	樮
樯	樯
樰	樰
樱	樱
樲	樲
樳	桪
樴	樴
樵	樵
樶	樶
樷	樷
樸	朴
樹	树
樺	桦
樻	樻
樼	樼
樽	樽
樾	樾
樿	椫
橀	橀
橁	橁
橂	橂
橃	橃
橄	橄
橅	橅
橆	橆
橇	橇
橈	桡
橉	橉
橊	橊
橋	桥
橌	橌
橍	橍
橎	橎
橏	橏
橐	橐
橑	橑
橒	橒
橓	橓
橔	橔
橕	橕
橖	橖
橗	橗
橘	橘
橙	橙
橚	橚
橛	橛
橜	橜
橝	橝
橞	橞
機	机
橠	橠
橡	橡
橢	椭
橣	橣
橤	橤
橥	橥
橦	橦
橧	橧
橨	橨
橩	橩
橪	橪
橫	横
橬	橬
橭	橭
橮	橮
橯	橯
橰	橰
橱	橱
橲	橲
橳	橳
橴	橴
橵	橵
橶	橶
橷	橷
橸	橸
橹	橹
橺	橺
橻	橻
橼	橼
橽	橽
橾	橾
橿	橿
檀	檀
檁	檩
檂	檂
檃	檃
檄	檄
檅	檅
檆	檆
檇	檇
檈	檈
檉	柽
檊	檊
檋	檋
檌	檌
檍	檍
檎	檎
檏	檏
檐	檐
檑	檑
檒	檒
檓	檓
檔	档
檕	檕
檖	檖
檗	檗
檘	檘
檙	檙
檚	檚
檛	檛
檜	桧
檝	檝
檞	檞
檟	槚
檠	檠
檡	檡
檢	检
檣	樯
檤	檤
檥	檥
檦	檦
檧	檧
檨	檨
檩	檩
檪	檪
檫	檫
檬	檬
檭	檭
檮	梼
檯	台
檰	檰
檱	檱
檲	檲
檳	槟
檴	檴
檵	檵
檶	檶
檷	檷
檸	柠
檹	檹
檺	檺
檻	槛
檼	檼
檽	檽
檾	檾
檿	檿
櫀	櫀
櫁	櫁
櫂	櫂
櫃	柜
櫄	櫄
櫅	櫅
櫆	櫆
櫇	櫇
櫈	櫈
櫉	櫉
櫊	櫊
櫋	櫋
櫌	櫌
櫍	櫍
櫎	櫎
櫏	櫏
櫐	櫐
櫑	櫑
櫒	櫒
櫓	橹
櫔	櫔
櫕	櫕
櫖	櫖
櫗	櫗
櫘	櫘
櫙	櫙
櫚	榈
櫛	栉
櫜	櫜
櫝	椟
櫞	橼
櫟	栎
櫠	櫠
櫡	櫡
櫢	櫢
櫣	櫣
櫤	櫤
櫥	橱
櫦	櫦
櫧	槠
櫨	栌
櫩	櫩
櫪	枥
櫫	橥
櫬	榇
櫭	櫭
櫮	櫮
櫯	櫯
櫰	櫰
櫱	蘖
櫲	櫲
櫳	栊
櫴	櫴
櫵	櫵
櫶	櫶
櫷	櫷
櫸	榉
櫹	櫹
櫺	櫺
櫻	樱
櫼	櫼
櫽	櫽
櫾	櫾
櫿	櫿
欀	欀
欁	欁
欂	欂
欃	欃
欄	栏
欅	欅
欆	欆
欇	欇
欈	欈
欉	欉
權	权
欋	欋
欌	欌
欍	欍
欎	欎
欏	椤
欐	欐
欑	欑
欒	栾
欓	欓
欔	欔
欕	欕
欖	榄
欗	欗
欘	欘
欙	欙
欚	欚
欛	欛
欜	欜
欝	欝
欞	棂
欟	欟
欠	欠
次	次
欢	欢
欣	欣
欤	欤
欥	欥
欦	欦
欧	欧
欨	欨
欩	欩
欪	欪
欫	欫
欬	欬
欭	欭
欮	欮
欯	欯
欰	欰
欱	欱
欲	欲
欳	欳
欴	欴
欵	欵
欶	欶
欷	欷
欸	欸
欹	欹
欺	欺
欻	欻
欼	欼
欽	钦
款	款
欿	欿
歀	歀
歁	歁
歂	歂
歃	歃
歄	歄
歅	歅
歆	歆
歇	歇
歈	歈
歉	歉
歊	歊
歋	歋
歌	歌
歍	歍
歎	歎
歏	歏
歐	欧
歑	歑
歒	歒
歓	歓
歔	歔
歕	歕
歖	歖
歗	歗
歘	歘
歙	歙
歚	歚
歛	歛
歜	歜
歝	歝
歞	歞
歟	欤
歠	歠
歡	欢
止	止
正	正
此	此
步	步
武	武
歧	歧
歨	歨
歩	歩
歪	歪
歫	歫
歬	歬
歭	歭
歮	歮
歯	歯
歰	歰
歱	歱
歲	岁
歳	歳
歴	歴
歵	歵
歶	歶
歷	历
歸	归
歹	歹
歺	歺
死	死
歼	歼
歽	歽
歾	歾
歿	殁
殀	殀
殁	殁
殂	殂
殃	殃
殄	殄
殅	殅
殆	殆
殇	殇
殈	殈
殉	殉
殊	殊
残	残
殌	殌
殍	殍
殎	殎
殏	殏
殐	殐
殑	殑
殒	殒
殓	殓
殔	殔
殕	殕
殖	殖
殗	殗
殘	残
殙	殙
殚	殚
殛	殛
殜	殜
殝	殝
殞	殒
殟	殟
殠	殠
殡	殡
殢	殢
殣	殣
殤	殇
殥	殥
殦	殦
殧	殧
殨	殨
殩	殩
殪	殪
殫	殚
殬	殬
殭	殭
殮	殓
殯	殡
殰	殰
殱	殱
殲	歼
殳	殳
殴	殴
段	段
殶	殶
殷	殷
殸	殸
殹	殹
殺	杀
殻	殻
殼	壳
殽	殽
殾	殾
殿	殿
毀	毁
毁	毁
毂	毂
毃	毃
毄	毄
毅	毅
毆	殴
毇	毇
毈	毈
毉	毉
毊	毊
毋	毋
毌	毌
母	母
毎	毎
每	每
毐	毐
毑	毑
毒	毒
毓	毓
比	比
毕	毕
毖	毖
毗	毗
毘	毘
毙	毙
毚	毚
毛	毛
毜	毜
毝	毝
毞	毞
毟	毟
毠	毠
毡	毡
毢	毢
毣	毣
毤	毤
毥	毥
毦	毦
毧	毧
毨	毨
毩	毩
毪	毪
毫	毫
毬	毬
毭	毭
毮	毮
毯	毯
毰	毰
毱	毱
毲	毲
毳	毳
毴	毴
毵	毵
毶	毶
毷	毷
毸	毸
毹	毹
毺	毺
毻	毻
毼	毼
毽	毽
毾	毾
毿	毵
氀	氀
氁	氁
氂	牦
氃	氃
氄	氄
氅	氅
氆	氆
氇	氇
氈	毡
氉	氉
氊	氊
氋	氋
氌	氇
氍	氍
氎	氎
氏	氏
氐	氐
民	民
氒	氒
氓	氓
气	气
氕	氕
氖	氖
気	気
氘	氘
氙	氙
氚	氚
氛	氛
氜	氜
氝	氝
氞	氞
氟	氟
氠	氠
氡	氡
氢	氢
氣	气
氤	氤
氥	氥
氦	氦
氧	氧
氨	氨
氩	氩
氪	氪
氫	氢
氬	氩
氭	氭
氮	氮
氯	氯
氰	氰
氱	氱
氲	氲
氳	氲
水	水
氵	氵
氶	氶
氷	氷
永	永
氹	氹
氺	氺
氻	氻
氼	氼
氽	氽
氾	氾
氿	氿
汀	汀
汁	汁
求	求
汃	汃
汄	汄
汅	汅
汆	汆
汇	汇
汈	汈
汉	汉
汊	汊
汋	汋
汌	汌
汍	汍
汎	汎
汏	汏
汐	汐
汑	汑
汒	汒
汓	汓
汔	汔
汕	汕
汖	汖
汗	汗
汘	汘
汙	汙
汚	汚
汛	汛
汜	汜
汝	汝
汞	汞
江	江
池	池
污	污
汢	汢
汣	汣
汤	汤
汥	汥
汦	汦
汧	汧
汨	汨
汩	汩
汪	汪
汫	汫
汬	汬
汭	汭
汮	汮
汯	汯
汰	汰
汱	汱
汲	汲
汳	汳
汴	汴
汵	汵
汶	汶
汷	汷
汸	汸
汹	汹
決	决
汻	汻
汼	汼
汽	汽
汾	汾
汿	汿
沀	沀
沁	沁
沂	沂
沃	沃
沄	沄
沅	沅
沆	沆
沇	沇
沈	沈
沉	沉
沊	沊
沋	沋
沌	沌
沍	沍
沎	沎
沏	沏
沐	沐
沑	沑
沒	没
沓	沓
沔	沔
沕	沕
沖	冲
沗	沗
沘	沘
沙	沙
沚	沚
沛	沛
沜	沜
沝	沝
沞	沞
沟	沟
沠	沠
没	没
沢	沢
沣	沣
沤	沤
沥	沥
沦	沦
沧	沧
沨	沨
沩	沩
沪	沪
沫	沫
沬	沬
沭	沭
沮	沮
沯	沯
沰	沰
沱	沱
沲	沲
河	河
沴	沴
沵	沵
沶	沶
沷	沷
沸	沸
油	油
沺	沺
治	治
沼	沼
沽	沽
沾	沾
沿	沿
泀	泀
況	况
泂	泂
泃	泃
泄	泄
泅	泅
泆	泆
泇	泇
泈	泈
泉	泉
泊	泊
泋	泋
泌	泌
泍	泍
泎	泎
泏	泏
泐	泐
泑	泑
泒	泒
泓	泓
泔	泔
法	法
泖	泖
泗	泗
泘	泘
泙	泙
泚	泚
泛	泛
泜	泜
泝	泝
泞	泞
泟	泟
泠	泠
泡	泡
波	波
泣	泣
泤	泤
泥	泥
泦	泦
泧	泧
注	注
泩	泩
泪	泪
泫	泫
泬	泬
泭	泭
泮	泮
泯	泯
泰	泰
泱	泱
泲	泲
泳	泳
泴	泴
泵	泵
泶	泶
泷	泷
泸	泸
泹	泹
泺	泺
泻	泻
泼	泼
泽	泽
泾	泾
泿	泿
洀	洀
洁	洁
洂	洂
洃	洃
洄	洄
洅	洅
洆	洆
洇	洇
洈	洈
洉	洉
洊	洊
洋	洋
洌	洌
洍	洍
洎	洎
洏	洏
洐	洐
洑	洑
洒	洒
洓	洓
洔	洔
洕	洕
洖	洖
洗	洗
洘	洘
洙	洙
洚	洚
洛	洛
洜	洜
洝	洝
洞	洞
洟	洟
洠	洠
洡	洡
洢	洢
洣	洣
洤	洤
津	津
洦	洦
洧	洧
洨	洨
洩	洩
洪	洪
洫	洫
洬	洬
洭	洭
洮	洮
洯	洯
洰	洰
洱	洱
洲	洲
洳	洳
洴	洴
洵	洵
洶	汹
洷	洷
洸	洸
洹	洹
洺	洺
活	活
洼	洼
洽	洽
派	派
洿	洿
浀	浀
流	流
浂	浂
浃	浃
浄	浄
浅	浅
浆	浆
浇	浇
浈	浈
浉	浉
浊	浊
测	测
浌	浌
浍	浍
济	济
浏	浏
浐	浐
浑	浑
浒	浒
浓	浓
浔	浔
浕	浕
浖	浖
浗	浗
浘	浘
浙	浙
浚	浚
浛	浛
浜	浜
浝	浝
浞	浞
浟	浟
浠	浠
浡	浡
浢	浢
浣	浣
浤	浤
浥	浥
浦	浦
浧	浧
浨	浨
浩	浩
浪	浪
浫	浫
浬	浬
浭	浭
浮	浮
浯	浯
浰	浰
浱	浱
浲	浲
浳	浳
浴	浴
浵	浵
浶	浶
海	海
浸	浸
浹	浃
浺	浺
浻	浻
浼	浼
浽	浽
浾	浾
浿	浿
涀	涀
涁	涁
涂	涂
涃	涃
涄	涄
涅	涅
涆	涆
涇	泾
消	消
涉	涉
涊	涊
涋	涋
涌	涌
涍	涍
涎	涎
涏	涏
涐	涐
涑	涑
涒	涒
涓	涓
涔	涔
涕	涕
涖	涖
涗	涗
涘	涘
涙	涙
涚	涚
涛	涛
涜	涜
涝	涝
涞	涞
涟	涟
涠	涠
涡	涡
涢	涢
涣	涣
涤	涤
涥	涥
润	润
涧	涧
涨	涨
涩	涩
涪	涪
涫	涫
涬	涬
涭	涭
涮	涮
涯	涯
涰	涰
涱	涱
液	液
涳	涳
涴	涴
涵	涵
涶	涶
涷	涷
涸	涸
涹	涹
涺	涺
涻	涻
涼	凉
涽	涽
涾	涾
涿	涿
淀	淀
淁	淁
淂	淂
淃	淃
淄	淄
淅	淅
淆	淆
淇	淇
淈	淈
淉	淉
淊	淊
淋	淋
淌	淌
淍	淍
淎	淎
淏	淏
淐	淐
淑	淑
淒	淒
淓	淓
淔	淔
淕	淕
淖	淖
淗	淗
淘	淘
淙	淙
淚	泪
淛	淛
淜	淜
淝	淝
淞	淞
淟	淟
淠	淠
淡	淡
淢	淢
淣	淣
淤	淤
淥	渌
淦	淦
淧	淧
淨	淨
淩	淩
淪	沦
淫	淫
淬	淬
淭	淭
淮	淮
淯	淯
淰	淰
深	深
淲	淲
淳	淳
淴	淴
淵	渊
淶	涞
混	混
淸	淸
淹	淹
淺	浅
添	添
淼	淼
淽	淽
淾	淾
淿	淿
渀	渀
渁	渁
渂	渂
渃	渃
渄	渄
清	清
渆	渆
渇	渇
済	済
渉	渉
渊	渊
渋	渋
渌	渌
渍	渍
渎	渎
渏	渏
渐	渐
渑	渑
渒	渒
渓	渓
渔	渔
渕	渕
渖	渖
渗	渗
渘	渘
渙	涣
渚	渚
減	减
渜	渜
渝	渝
渞	渞
渟	渟
渠	渠
渡	渡
渢	沨
渣	渣
渤	渤
渥	渥
渦	涡
渧	渧
渨	渨
温	温
渪	渪
渫	渫
測	测
渭	渭
渮	渮
港	港
渰	渰
渱	渱
渲	渲
渳	渳
渴	渴
渵	渵
渶	渶
渷	渷
游	游
渹	渹
渺	渺
渻	渻
渼	渼
渽	渽
渾	浑
渿	渿
湀	湀
湁	湁
湂	湂
湃	湃
湄	湄
湅	湅
湆	湆
湇	湇
湈	湈
湉	湉
湊	凑
湋	湋
湌	湌
湍	湍
湎	湎
湏	湏
湐	湐
湑	湑
湒	湒
湓	湓
湔	湔
湕	湕
湖	湖
湗	湗
湘	湘
湙	湙
湚	湚
湛	湛
湜	湜
湝	湝
湞	浈
湟	湟
湠	湠
湡	湡
湢	湢
湣	湣
湤	湤
湥	湥
湦	湦
湧	湧
湨	湨
湩	湩
湪	湪
湫	湫
湬	湬
湭	湭
湮	湮
湯	汤
湰	湰
湱	湱
湲	湲
湳	湳
湴	湴
湵	湵
湶	湶
湷	湷
湸	湸
湹	湹
湺	湺
湻	湻
湼	湼
湽	湽
湾	湾
湿	湿
満	満
溁	溁
溂	溂
溃	溃
溄	溄
溅	溅
溆	溆
溇	溇
溈	沩
溉	溉
溊	溊
溋	溋
溌	溌
溍	溍
溎	溎
溏	溏
源	源
溑	溑
溒	溒
溓	溓
溔	溔
溕	溕
準	准
溗	溗
溘	溘
溙	溙
溚	溚
溛	溛
溜	溜
溝	沟
溞	溞
溟	溟
溠	溠
溡	溡
溢	溢
溣	溣
溤	溤
溥	溥
溦	溦
溧	溧
溨	溨
溩	溩
溪	溪
溫	温
溬	溬
溭	溭
溮	溮
溯	溯
溰	溰
溱	溱
溲	溲
溳	涢
溴	溴
溵	溵
溶	溶
溷	溷
溸	溸
溹	溹
溺	溺
溻	溻
溼	溼
溽	溽
溾	溾
溿	溿
滀	滀
滁	滁
滂	滂
滃	滃
滄	沧
滅	灭
滆	滆
滇	滇
滈	滈
滉	滉
滊	滊
滋	滋
滌	涤
滍	滍
滎	荥
滏	滏
滐	滐
滑	滑
滒	滒
滓	滓
滔	滔
滕	滕
滖	滖
滗	滗
滘	滘
滙	滙
滚	滚
滛	滛
滜	滜
滝	滝
滞	滞
滟	滟
滠	滠
满	满
滢	滢
滣	滣
滤	滤
滥	滥
滦	滦
滧	滧
滨	滨
滩	滩
滪	滪
滫	滫
滬	沪
滭	滭
滮	滮
滯	滞
滰	滰
滱	滱
滲	渗
滳	滳
滴	滴
滵	滵
滶	滶
滷	滷
滸	浒
滹	滹
滺	滺
滻	浐
滼	滼
滽	滽
滾	滚
滿	满
漀	漀
漁	渔
漂	漂
漃	漃
漄	漄
漅	漅
漆	漆
漇	漇
漈	漈
漉	漉
漊	溇
漋	漋
漌	漌
漍	漍
漎	漎
漏	漏
漐	漐
漑	漑
漒	漒
漓	漓
演	演
漕	漕
漖	漖
漗	漗
漘	漘
漙	漙
漚	沤
漛	漛
漜	漜
漝	漝
漞	漞
漟	漟
漠	漠
漡	漡
漢	汉
漣	涟
漤	漤
漥	漥
漦	漦
漧	漧
漨	漨
漩	漩
漪	漪
漫	漫
漬	渍
漭	漭
漮	漮
漯	漯
漰	漰
漱	漱
漲	涨
漳	漳
漴	漴
漵	溆
漶	漶
漷	漷
漸	渐
漹	漹
漺	漺
漻	漻
漼	漼
漽	漽
漾	漾
漿	浆
潀	潀
潁	颍
潂	潂
潃	潃
潄	潄
潅	潅
潆	潆
潇	潇
潈	潈
潉	潉
潊	潊
潋	潋
潌	潌
潍	潍
潎	潎
潏	潏
潐	潐
潑	泼
潒	潒
潓	潓
潔	洁
潕	潕
潖	潖
潗	潗
潘	潘
潙	潙
潚	潚
潛	潜
潜	潜
潝	潝
潞	潞
潟	潟
潠	潠
潡	潡
潢	潢
潣	潣
潤	润
潥	潥
潦	潦
潧	潧
潨	潨
潩	潩
潪	潪
潫	潫
潬	潬
潭	潭
潮	潮
潯	浔
潰	溃
潱	潱
潲	潲
潳	潳
潴	潴
潵	潵
潶	潶
潷	滗
潸	潸
潹	潹
潺	潺
潻	潻
潼	潼
潽	潽
潾	潾
潿	涠
澀	涩
澁	澁
澂	澂
澃	澃
澄	澄
澅	澅
澆	浇
澇	涝
澈	澈
澉	澉
澊	澊
澋	澋
澌	澌
澍	澍
澎	澎
澏	澏
澐	澐
澑	澑
澒	澒
澓	澓
澔	澔
澕	澕
澖	澖
澗	涧
澘	澘
澙	澙
澚	澚
澛	澛
澜	澜
澝	澝
澞	澞
澟	澟
澠	渑
澡	澡
澢	澢
澣	澣
澤	泽
澥	澥
澦	滪
澧	澧
澨	澨
澩	泶
澪	澪
澫	澫
澬	澬
澭	澭
澮	浍
澯	澯
澰	澰
澱	淀
澲	澲
澳	澳
澴	澴
澵	澵
澶	澶
澷	澷
澸	澸
澹	澹
澺	澺
澻	澻
澼	澼
澽	澽
澾	澾
澿	澿
激	激
濁	浊
濂	濂
濃	浓
濄	濄
濅	濅
濆	濆
濇	濇
濈	濈
濉	濉
濊	濊
濋	濋
濌	濌
濍	濍
濎	濎
濏	濏
濐	濐
濑	濑
濒	濒
濓	濓
濔	濔
濕	湿
濖	濖
濗	濗
濘	泞
濙	濙
濚	濚
濛	濛
濜	浕
濝	濝
濞	濞
濟	济
濠	濠
濡	濡
濢	濢
濣	濣
濤	涛
濥	濥
濦	濦
濧	濧
濨	濨
濩	濩
濪	濪
濫	滥
濬	濬
濭	濭
濮	濮
濯	濯
濰	潍
濱	滨
濲	濲
濳	濳
濴	濴
濵	濵
濶	濶
濷	濷
濸	濸
濹	濹
濺	溅
濻	濻
濼	泺
濽	濽
濾	滤
濿	濿
瀀	瀀
瀁	瀁
瀂	澛
瀃	瀃
瀄	瀄
瀅	滢
瀆	渎
瀇	瀇
瀈	瀈
瀉	泻
瀊	瀊
瀋	沈
瀌	瀌
瀍	瀍
瀎	瀎
瀏	浏
瀐	瀐
瀑	瀑
瀒	瀒
瀓	瀓
瀔	瀔
瀕	濒
瀖	瀖
瀗	瀗
瀘	泸
瀙	瀙
瀚	瀚
瀛	瀛
瀜	瀜
瀝	沥
瀞	瀞
瀟	潇
瀠	潆
瀡	瀡
瀢	瀢
瀣	瀣
瀤	瀤
瀥	瀥
瀦	潴
瀧	泷
瀨	濑
瀩	瀩
瀪	瀪
瀫	瀫
瀬	瀬
瀭	瀭
瀮	瀮
瀯	瀯
瀰	瀰
瀱	瀱
瀲	潋
瀳	瀳
瀴	瀴
瀵	瀵
瀶	瀶
瀷	瀷
瀸	瀸
瀹	瀹
瀺	瀺
瀻	瀻
瀼	瀼
瀽	瀽
瀾	澜
瀿	瀿
灀	灀
灁	灁
灂	灂
灃	沣
灄	滠
灅	灅
灆	灆
灇	灇
灈	灈
灉	灉
灊	灊
灋	灋
灌	灌
灍	灍
灎	灎
灏	灏
灐	灐
灑	洒
灒	灒
灓	灓
灔	灔
灕	漓
灖	灖
灗	灗
灘	滩
灙	灙
灚	灚
灛	灛
灜	灜
灝	灏
灞	灞
灟	灟
灠	漤
灡	灡
灢	灢
灣	湾
灤	滦
灥	灥
灦	灦
灧	滟
灨	灨
灩	灩
灪	灪
火	火
灬	灬
灭	灭
灮	灮
灯	灯
灰	灰
灱	灱
灲	灲
灳	灳
灴	灴
灵	灵
灶	灶
灷	灷
灸	灸
灹	灹
灺	灺
灻	灻
灼	灼
災	灾
灾	灾
灿	灿
炀	炀
炁	炁
炂	炂
炃	炃
炄	炄
炅	炅
炆	炆
炇	炇
炈	炈
炉	炉
炊	炊
炋	炋
炌	炌
炍	炍
炎	炎
炏	炏
炐	炐
炑	炑
炒	炒
炓	炓
炔	炔
炕	炕
炖	炖
炗	炗
炘	炘
炙	炙
炚	炚
炛	炛
炜	炜
炝	炝
炞	炞
炟	炟
炠	炠
炡	炡
炢	炢
炣	炣
炤	炤
炥	炥
炦	炦
炧	炧
炨	炨
炩	炩
炪	炪
炫	炫
炬	炬
炭	炭
炮	炮
炯	炯
炰	炰
炱	炱
炲	炲
炳	炳
炴	炴
炵	炵
炶	炶
炷	炷
炸	炸
点	点
為	为
炻	炻
炼	炼
炽	炽
炾	炾
炿	炿
烀	烀
烁	烁
烂	烂
烃	烃
烄	烄
烅	烅
烆	烆
烇	烇
烈	烈
烉	烉
烊	烊
烋	烋
烌	烌
烍	烍
烎	烎
烏	乌
烐	烐
烑	烑
烒	烒
烓	烓
烔	烔
烕	烕
烖	烖
烗	烗
烘	烘
烙	烙
烚	烚
烛	烛
烜	烜
烝	烝
烞	烞
烟	烟
烠	烠
烡	烡
烢	烢
烣	烣
烤	烤
烥	烥
烦	烦
烧	烧
烨	烨
烩	烩
烪	烪
烫	烫
烬	烬
热	热
烮	烮
烯	烯
烰	烰
烱	烱
烲	烲
烳	烳
烴	烃
烵	烵
烶	烶
烷	烷
烸	烸
烹	烹
烺	烺
烻	烻
烼	烼
烽	烽
烾	烾
烿	烿
焀	焀
焁	焁
焂	焂
焃	焃
焄	焄
焅	焅
焆	焆
焇	焇
焈	焈
焉	焉
焊	焊
焋	焋
焌	焌
焍	焍
焎	焎
焏	焏
焐	焐
焑	焑
焒	焒
焓	焓
焔	焔
焕	焕
焖	焖
焗	焗
焘	焘
焙	焙
焚	焚
焛	焛
焜	焜
焝	焝
焞	焞
焟	焟
焠	焠
無	无
焢	焢
焣	焣
焤	焤
焥	焥
焦	焦
焧	焧
焨	焨
焩	焩
焪	焪
焫	焫
焬	焬
焭	焭
焮	焮
焯	焯
焰	焰
焱	焱
焲	焲
焳	焳
焴	焴
焵	焵
然	然
焷	焷
焸	焸
焹	焹
焺	焺
焻	焻
焼	焼
焽	焽
焾	焾
焿	焿
煀	煀
煁	煁
煂	煂
煃	煃
煄	煄
煅	煅
煆	煆
煇	煇
煈	煈
煉	炼
煊	煊
煋	煋
煌	煌
煍	煍
煎	煎
煏	煏
煐	煐
煑	煑
煒	炜
煓	煓
煔	煔
煕	煕
煖	煖
煗	煗
煘	煘
煙	烟
煚	煚
煛	煛
煜	煜
煝	煝
煞	煞
煟	煟
煠	煠
煡	煡
煢	茕
煣	煣
煤	煤
煥	焕
煦	煦
照	照
煨	煨
煩	烦
煪	煪
煫	煫
煬	炀
煭	煭
煮	煮
煯	煯
煰	煰
煱	煱
煲	煲
煳	煳
煴	煴
煵	煵
煶	煶
煷	煷
煸	煸
煹	煹
煺	煺
煻	煻
煼	煼
煽	煽
煾	煾
煿	煿
熀	熀
熁	熁
熂	熂
熃	熃
熄	熄
熅	煴
熆	熆
熇	熇
熈	熈
熉	熉
熊	熊
熋	熋
熌	熌
熍	熍
熎	熎
熏	熏
熐	熐
熑	熑
熒	荧
熓	熓
熔	熔
熕	熕
熖	熖
熗	炝
熘	熘
熙	熙
熚	熚
熛	熛
熜	熜
熝	熝
熞	熞
熟	熟
熠	熠
熡	熡
熢	熢
熣	熣
熤	熤
熥	熥
熦	熦
熧	熧
熨	熨
熩	熩
熪	熪
熫	熫
熬	熬
熭	熭
熮	熮
熯	熯
熰	熰
熱	热
熲	颎
熳	熳
熴	熴
熵	熵
熶	熶
熷	熷
熸	熸
熹	熹
熺	熺
熻	熻
熼	熼
熽	熽
熾	炽
熿	熿
燀	燀
燁	烨
燂	燂
燃	燃
燄	燄
燅	燅
燆	燆
燇	燇
燈	灯
燉	燉
燊	燊
燋	燋
燌	燌
燍	燍
燎	燎
燏	燏
燐	燐
燑	燑
燒	烧
燓	燓
燔	燔
燕	燕
燖	燖
燗	燗
燘	燘
燙	烫
燚	燚
燛	燛
燜	焖
燝	燝
燞	燞
營	营
燠	燠
燡	燡
燢	燢
燣	燣
燤	燤
燥	燥
燦	灿
燧	燧
燨	燨
燩	燩
燪	燪
燫	燫
燬	燬
燭	烛
燮	燮
燯	燯
燰	燰
燱	燱
燲	燲
燳	燳
燴	烩
燵	燵
燶	燶
燷	燷
燸	燸
燹	燹
燺	燺
燻	燻
燼	烬
燽	燽
燾	焘
燿	燿
爀	爀
爁	爁
爂	爂
爃	爃
爄	爄
爅	爅
爆	爆
爇	爇
爈	爈
爉	爉
爊	爊
爋	爋
爌	爌
爍	烁
爎	爎
爏	爏
爐	炉
爑	爑
爒	爒
爓	爓
爔	爔
爕	爕
爖	爖
爗	爗
爘	爘
爙	爙
爚	爚
爛	烂
爜	爜
爝	爝
爞	爞
爟	爟
爠	爠
爡	爡
爢	爢
爣	爣
爤	爤
爥	爥
爦	爦
爧	爧
爨	爨
爩	爩
爪	爪
爫	爫
爬	爬
爭	争
爮	爮
爯	爯
爰	爰
爱	爱
爲	爲
爳	爳
爴	爴
爵	爵
父	父
爷	爷
爸	爸
爹	爹
爺	爷
爻	爻
爼	爼
爽	爽
爾	尔
爿	爿
牀	牀
牁	牁
牂	牂
牃	牃
牄	牄
牅	牅
牆	墙
片	片
版	版
牉	牉
牊	牊
牋	牋
牌	牌
牍	牍
牎	牎
牏	牏
牐	牐
牑	牑
牒	牒
牓	牓
牔	牔
牕	牕
牖	牖
牗	牗
牘	牍
牙	牙
牚	牚
牛	牛
牜	牜
牝	牝
牞	牞
牟	牟
牠	牠
牡	牡
牢	牢
牣	牣
牤	牤
牥	牥
牦	牦
牧	牧
牨	牨
物	物
牪	牪
牫	牫
牬	牬
牭	牭
牮	牮
牯	牯
牰	牰
牱	牱
牲	牲
牳	牳
牴	牴
牵	牵
牶	牶
牷	牷
牸	牸
特	特
牺	牺
牻	牻
牼	牼
牽	牵
牾	牾
牿	牿
犀	犀
犁	犁
犂	犂
犃	犃
犄	犄
犅	犅
犆	犆
犇	犇
犈	犈
犉	犉
犊	犊
犋	犋
犌	犌
犍	犍
犎	犎
犏	犏
犐	犐
犑	犑
犒	犒
犓	犓
犔	犔
犕	犕
犖	荦
犗	犗
犘	犘
犙	犙
犚	犚
犛	犛
犜	犜
犝	犝
犞	犞
犟	犟
犠	犠
犡	犡
犢	犊
犣	犣
犤	犤
犥	犥
犦	犦
犧	牺
犨	犨
犩	犩
犪	犪
犫	犫
犬	犬
犭	犭
犮	犮
犯	犯
犰	犰
犱	犱
犲	犲
犳	犳
犴	犴
犵	犵
状	状
犷	犷
犸	犸
犹	犹
犺	犺
犻	犻
犼	犼
犽	犽
犾	犾
犿	犿
狀	状
狁	狁
狂	狂
狃	狃
狄	狄
狅	狅
狆	狆
狇	狇
狈	狈
狉	狉
狊	狊
狋	狋
狌	狌
狍	狍
狎	狎
狏	狏
狐	狐
狑	狑
狒	狒
狓	狓
狔	狔
狕	狕
狖	狖
狗	狗
狘	狘
狙	狙
狚	狚
狛	狛
狜	狜
狝	狝
狞	狞
狟	狟
狠	狠
狡	狡
狢	狢
狣	狣
狤	狤
狥	狥
狦	狦
狧	狧
狨	狨
狩	狩
狪	狪
狫	狫
独	独
狭	狭
狮	狮
狯	狯
狰	狰
狱	狱
狲	狲
狳	狳
狴	狴
狵	狵
狶	狶
狷	狷
狸	狸
狹	狭
狺	狺
狻	狻
狼	狼
狽	狈
狾	狾
狿	狿
猀	猀
猁	猁
猂	猂
猃	猃
猄	猄
猅	猅
猆	猆
猇	猇
猈	猈
猉	猉
猊	猊
猋	猋
猌	猌
猍	猍
猎	猎
猏	猏
猐	猐
猑	猑
猒	猒
猓	猓
猔	猔
猕	猕
猖	猖
猗	猗
猘	猘
猙	狰
猚	猚
猛	猛
猜	猜
猝	猝
猞	猞
猟	猟
猠	猠
猡	猡
猢	猢
猣	猣
猤	猤
猥	猥
猦	猦
猧	猧
猨	猨
猩	猩
猪	猪
猫	猫
猬	猬
猭	猭
献	献
猯	猯
猰	猰
猱	猱
猲	猲
猳	猳
猴	猴
猵	猵
猶	犹
猷	猷
猸	猸
猹	猹
猺	猺
猻	狲
猼	猼
猽	猽
猾	猾
猿	猿
獀	獀
獁	犸
獂	獂
獃	獃
獄	狱
獅	狮
獆	獆
獇	獇
獈	獈
獉	獉
獊	獊
獋	獋
獌	獌
獍	獍
獎	奖
獏	獏
獐	獐
獑	獑
獒	獒
獓	獓
獔	獔
獕	獕
獖	獖
獗	獗
獘	獘
獙	獙
獚	獚
獛	獛
獜	獜
獝	獝
獞	獞
獟	獟
獠	獠
獡	獡
獢	獢
獣	獣
獤	獤
獥	獥
獦	獦
獧	獧
獨	独
獩	獩
獪	狯
獫	猃
獬	獬
獭	獭
獮	狝
獯	獯
獰	狞
獱	獱
獲	获
獳	獳
獴	獴
獵	猎
獶	獶
獷	犷
獸	兽
獹	獹
獺	獭
獻	献
獼	猕
獽	獽
獾	獾
獿	獿
玀	猡
玁	玁
玂	玂
玃	玃
玄	玄
玅	玅
玆	玆
率	率
玈	玈
玉	玉
玊	玊
王	王
玌	玌
玍	玍
玎	玎
玏	玏
玐	玐
玑	玑
玒	玒
玓	玓
玔	玔
玕	玕
玖	玖
玗	玗
玘	玘
玙	玙
玚	玚
玛	玛
玜	玜
玝	玝
玞	玞
玟	玟
玠	玠
玡	玡
玢	玢
玣	玣
玤	玤
玥	玥
玦	玦
玧	玧
玨	玨
玩	玩
玪	玪
玫	玫
玬	玬
玭	玭
玮	玮
环	环
现	现
玱	玱
玲	玲
玳	玳
玴	玴
玵	玵
玶	玶
玷	玷
玸	玸
玹	玹
玺	玺
玻	玻
玼	玼
玽	玽
玾	玾
玿	玿
珀	珀
珁	珁
珂	珂
珃	珃
珄	珄
珅	珅
珆	珆
珇	珇
珈	珈
珉	珉
珊	珊
珋	珋
珌	珌
珍	珍
珎	珎
珏	珏
珐	珐
珑	珑
珒	珒
珓	珓
珔	珔
珕	珕
珖	珖
珗	珗
珘	珘
珙	珙
珚	珚
珛	珛
珜	珜
珝	珝
珞	珞
珟	珟
珠	珠
珡	珡
珢	珢
珣	珣
珤	珤
珥	珥
珦	珦
珧	珧
珨	珨
珩	珩
珪	珪
珫	珫
珬	珬
班	班
珮	珮
珯	珯
珰	珰
珱	珱
珲	珲
珳	珳
珴	珴
珵	珵
珶	珶
珷	珷
珸	珸
珹	珹
珺	珺
珻	珻
珼	珼
珽	珽
現	现
珿	珿
琀	琀
琁	琁
琂	琂
球	球
琄	琄
琅	琅
理	理
琇	琇
琈	琈
琉	琉
琊	琊
琋	琋
琌	琌
琍	琍
琎	琎
琏	琏
琐	琐
琑	琑
琒	琒
琓	琓
琔	琔
琕	琕
琖	琖
琗	琗
琘	琘
琙	琙
琚	琚
琛	琛
琜	琜
琝	琝
琞	琞
琟	琟
琠	琠
琡	琡
琢	琢
琣	琣
琤	琤
琥	琥
琦	琦
琧	琧
琨	琨
琩	琩
琪	琪
琫	琫
琬	琬
琭	琭
琮	琮
琯	琯
琰	琰
琱	琱
琲	琲
琳	琳
琴	琴
琵	琵
琶	琶
琷	琷
琸	琸
琹	琹
琺	珐
琻	琻
琼	琼
琽	琽
琾	琾
琿	珲
瑀	瑀
瑁	瑁
瑂	瑂
瑃	瑃
瑄	瑄
瑅	瑅
瑆	瑆
瑇	瑇
瑈	瑈
瑉	瑉
瑊	瑊
瑋	玮
瑌	瑌
瑍	瑍
瑎	瑎
瑏	瑏
瑐	瑐
瑑	瑑
瑒	玚
瑓	瑓
瑔	瑔
瑕	瑕
瑖	瑖
瑗	瑗
瑘	瑘
瑙	瑙
瑚	瑚
瑛	瑛
瑜	瑜
瑝	瑝
瑞	瑞
瑟	瑟
瑠	瑠
瑡	瑡
瑢	瑢
瑣	琐
瑤	瑶
瑥	瑥
瑦	瑦
瑧	瑧
瑨	瑨
瑩	莹
瑪	玛
瑫	瑫
瑬	瑬
瑭	瑭
瑮	瑮
瑯	瑯
瑰	瑰
瑱	瑱
瑲	玱
瑳	瑳
瑴	瑴
瑵	瑵
瑶	瑶
瑷	瑷
瑸	瑸
瑹	瑹
瑺	瑺
瑻	瑻
瑼	瑼
瑽	瑽
瑾	瑾
瑿	瑿
璀	璀
璁	璁
璂	璂
璃	璃
璄	璄
璅	璅
璆	璆
璇	璇
璈	璈
璉	琏
璊	璊
璋	璋
璌	璌
璍	璍
璎	璎
璏	璏
璐	璐
璑	璑
璒	璒
璓	璓
璔	璔
璕	璕
璖	璖
璗	璗
璘	璘
璙	璙
璚	璚
璛	璛
璜	璜
璝	璝
璞	璞
璟	璟
璠	璠
璡	璡
璢	璢
璣	玑
璤	璤
璥	璥
璦	瑷
璧	璧
璨	璨
璩	璩
璪	璪
璫	珰
璬	璬
璭	璭
璮	璮
璯	璯
環	环
璱	璱
璲	璲
璳	璳
璴	璴
璵	璵
璶	璶
璷	璷
璸	璸
璹	璹
璺	璺
璻	璻
璼	璼
璽	玺
璾	璾
璿	璿
瓀	瓀
瓁	瓁
瓂	瓂
瓃	瓃
瓄	瓄
瓅	瓅
瓆	瓆
瓇	瓇
瓈	瓈
瓉	瓉
瓊	琼
瓋	瓋
瓌	瓌
瓍	瓍
瓎	瓎
瓏	珑
瓐	瓐
瓑	瓑
瓒	瓒
瓓	瓓
瓔	璎
瓕	瓕
瓖	瓖
瓗	瓗
瓘	瓘
瓙	瓙
瓚	瓒
瓛	瓛
瓜	瓜
瓝	瓝
瓞	瓞
瓟	瓟
瓠	瓠
瓡	瓡
瓢	瓢
瓣	瓣
瓤	瓤
瓥	瓥
瓦	瓦
瓧	瓧
瓨	瓨
瓩	瓩
瓪	瓪
瓫	瓫
瓬	瓬
瓭	瓭
瓮	瓮
瓯	瓯
瓰	瓰
瓱	瓱
瓲	瓲
瓳	瓳
瓴	瓴
瓵	瓵
瓶	瓶
瓷	瓷
瓸	瓸
瓹	瓹
瓺	瓺
瓻	瓻
瓼	瓼
瓽	瓽
瓾	瓾
瓿	瓿
甀	甀
甁	甁
甂	甂
甃	甃
甄	甄
甅	甅
甆	甆
甇	甇
甈	甈
甉	甉
甊	甊
甋	甋
甌	瓯
甍	甍
甎	甎
甏	甏
甐	甐
甑	甑
甒	甒
甓	甓
甔	甔
甕	甕
甖	甖
甗	甗
甘	甘
甙	甙
甚	甚
甛	甛
甜	甜
甝	甝
甞	甞
生	生
甠	甠
甡	甡
產	产
産	産
甤	甤
甥	甥
甦	甦
甧	甧
用	用
甩	甩
甪	甪
甫	甫
甬	甬
甭	甭
甮	甮
甯	甯
田	田
由	由
甲	甲
申	申
甴	甴
电	电
甶	甶
男	男
甸	甸
甹	甹
町	町
画	画
甼	甼
甽	甽
甾	甾
甿	甿
畀	畀
畁	畁
畂	畂
畃	畃
畄	畄
畅	畅
畆	畆
畇	畇
畈	畈
畉	畉
畊	畊
畋	畋
界	界
畍	畍
畎	畎
畏	畏
畐	畐
畑	畑
畒	畒
畓	畓
畔	畔
畕	畕
畖	畖
畗	畗
畘	畘
留	留
畚	畚
畛	畛
畜	畜
畝	亩
畞	畞
畟	畟
畠	畠
畡	畡
畢	毕
畣	畣
畤	畤
略	略
畦	畦
畧	畧
畨	畨
畩	畩
番	番
畫	画
畬	畬
畭	畭
畮	畮
畯	畯
異	异
畱	畱
畲	畲
畳	畳
畴	畴
畵	畵
當	当
畷	畷
畸	畸
畹	畹
畺	畺
畻	畻
畼	畼
畽	畽
畾	畾
畿	畿
疀	疀
疁	疁
疂	疂
疃	疃
疄	疄
疅	疅
疆	疆
疇	畴
疈	疈
疉	疉
疊	叠
疋	疋
疌	疌
疍	疍
疎	疎
疏	疏
疐	疐
疑	疑
疒	疒
疓	疓
疔	疔
疕	疕
疖	疖
疗	疗
疘	疘
疙	疙
疚	疚
疛	疛
疜	疜
疝	疝
疞	疞
疟	疟
疠	疠
疡	疡
疢	疢
疣	疣
疤	疤
疥	疥
疦	疦
疧	疧
疨	疨
疩	疩
疪	疪
疫	疫
疬	疬
疭	疭
疮	疮
疯	疯
疰	疰
疱	疱
疲	疲
疳	疳
疴	疴
疵	疵
疶	疶
疷	疷
疸	疸
疹	疹
疺	疺
疻	疻
疼	疼
疽	疽
疾	疾
疿	疿
痀	痀
痁	痁
痂	痂
痃	痃
痄	痄
病	病
痆	痆
症	症
痈	痈
痉	痉
痊	痊
痋	痋
痌	痌
痍	痍
痎	痎
痏	痏
痐	痐
痑	痑
痒	痒
痓	痓
痔	痔
痕	痕
痖	痖
痗	痗
痘	痘
痙	痉
痚	痚
痛	痛
痜	痜
痝	痝
痞	痞
痟	痟
痠	痠
痡	痡
痢	痢
痣	痣
痤	痤
痥	痥
痦	痦
痧	痧
痨	痨
痩	痩
痪	痪
痫	痫
痬	痬
痭	痭
痮	痮
痯	痯
痰	痰
痱	痱
痲	痲
痳	痳
痴	痴
痵	痵
痶	痶
痷	痷
痸	痸
痹	痹
痺	痺
痻	痻
痼	痼
痽	痽
痾	疴
痿	痿
瘀	瘀
瘁	瘁
瘂	痖
瘃	瘃
瘄	瘄
瘅	瘅
瘆	瘆
瘇	瘇
瘈	瘈
瘉	瘉
瘊	瘊
瘋	疯
瘌	瘌
瘍	疡
瘎	瘎
瘏	瘏
瘐	瘐
瘑	瘑
瘒	瘒
瘓	痪
瘔	瘔
瘕	瘕
瘖	瘖
瘗	瘗
瘘	瘘
瘙	瘙
瘚	瘚
瘛	瘛
瘜	瘜
瘝	瘝
瘞	瘗
瘟	瘟
瘠	瘠
瘡	疮
瘢	瘢
瘣	瘣
瘤	瘤
瘥	瘥
瘦	瘦
瘧	疟
瘨	瘨
瘩	瘩
瘪	瘪
瘫	瘫
瘬	瘬
瘭	瘭
瘮	瘆
瘯	瘯
瘰	瘰
瘱	瘱
瘲	疭
瘳	瘳
瘴	瘴
瘵	瘵
瘶	瘶
瘷	瘷
瘸	瘸
瘹	瘹
瘺	瘘
瘻	瘻
瘼	瘼
瘽	瘽
瘾	瘾
瘿	瘿
癀	癀
癁	癁
療	疗
癃	癃
癄	癄
癅	癅
癆	痨
癇	痫
癈	癈
癉	瘅
癊	癊
癋	癋
癌	癌
癍	癍
癎	癎
癏	癏
癐	癐
癑	癑
癒	癒
癓	癓
癔	癔
癕	癕
癖	癖
癗	癗
癘	疠
癙	癙
癚	癚
癛	癛
癜	癜
癝	癝
癞	癞
癟	瘪
癠	癠
癡	癡
癢	痒
癣	癣
癤	疖
癥	症
癦	癦
癧	疬
癨	癨
癩	癞
癪	癪
癫	癫
癬	癣
癭	瘿
癮	瘾
癯	癯
癰	痈
癱	瘫
癲	癫
癳	癳
癴	癴
癵	癵
癶	癶
癷	癷
癸	癸
癹	癹
発	発
登	登
發	发
白	白
百	百
癿	癿
皀	皀
皁	皁
皂	皂
皃	皃
的	的
皅	皅
皆	皆
皇	皇
皈	皈
皉	皉
皊	皊
皋	皋
皌	皌
皍	皍
皎	皎
皏	皏
皐	皐
皑	皑
皒	皒
皓	皓
皔	皔
皕	皕
皖	皖
皗	皗
皘	皘
皙	皙
皚	皑
皛	皛
皜	皜
皝	皝
皞	皞
皟	皟
皠	皠
皡	皡
皢	皢
皣	皣
皤	皤
皥	皥
皦	皦
皧	皧
皨	皨
皩	皩
皪	皪
皫	皫
皬	皬
皭	皭
皮	皮
皯	皯
皰	疱
皱	皱
皲	皲
皳	皳
皴	皴
皵	皵
皶	皶
皷	皷
皸	皲
皹	皹
皺	皱
皻	皻
皼	皼
皽	皽
皾	皾
皿	皿
盀	盀
盁	盁
盂	盂
盃	盃
盄	盄
盅	盅
盆	盆
盇	盇
盈	盈
盉	盉
益	益
盋	盋
盌	盌
盍	盍
盎	盎
盏	盏
盐	盐
监	监
盒	盒
盓	盓
盔	盔
盕	盕
盖	盖
盗	盗
盘	盘
盙	盙
盚	盚
盛	盛
盜	盗
盝	盝
盞	盏
盟	盟
盠	盠
盡	尽
盢	盢
監	监
盤	盘
盥	盥
盦	盦
盧	卢
盨	盨
盩	盩
盪	荡
盫	盫
盬	盬
盭	盭
目	目
盯	盯
盰	盰
盱	盱
盲	盲
盳	盳
直	直
盵	盵
盶	盶
盷	盷
相	相
盹	盹
盺	盺
盻	盻
盼	盼
盽	盽
盾	盾
盿	盿
眀	眀
省	省
眂	眂
眃	眃
眄	眄
眅	眅
眆	眆
眇	眇
眈	眈
眉	眉
眊	眊
看	看
県	県
眍	眍
眎	眎
眏	眏
眐	眐
眑	眑
眒	眒
眓	眓
眔	眔
眕	眕
眖	眖
眗	眗
眘	眘
眙	眙
眚	眚
眛	眛
眜	眜
眝	眝
眞	眞
真	真
眠	眠
眡	眡
眢	眢
眣	眣
眤	眤
眥	眦
眦	眦
眧	眧
眨	眨
眩	眩
眪	眪
眫	眫
眬	眬
眭	眭
眮	眮
眯	眯
眰	眰
眱	眱
眲	眲
眳	眳
眴	眴
眵	眵
眶	眶
眷	眷
眸	眸
眹	眹
眺	眺
眻	眻
眼	眼
眽	眽
眾	众
眿	眿
着	着
睁	睁
睂	睂
睃	睃
睄	睄
睅	睅
睆	睆
睇	睇
睈	睈
睉	睉
睊	睊
睋	睋
睌	睌
睍	睍
睎	睎
睏	困
睐	睐
睑	睑
睒	睒
睓	睓
睔	睔
睕	睕
睖	睖
睗	睗
睘	睘
睙	睙
睚	睚
睛	睛
睜	睁
睝	睝
睞	睐
睟	睟
睠	睠
睡	睡
睢	睢
督	督
睤	睤
睥	睥
睦	睦
睧	睧
睨	睨
睩	睩
睪	睪
睫	睫
睬	睬
睭	睭
睮	睮
睯	睯
睰	睰
睱	睱
睲	睲
睳	睳
睴	睴
睵	睵
睶	睶
睷	睷
睸	睸
睹	睹
睺	睺
睻	睻
睼	睼
睽	睽
睾	睾
睿	睿
瞀	瞀
瞁	瞁
瞂	瞂
瞃	瞃
瞄	瞄
瞅	瞅
瞆	瞆
瞇	瞇
瞈	瞈
瞉	瞉
瞊	瞊
瞋	瞋
瞌	瞌
瞍	瞍
瞎	瞎
瞏	瞏
瞐	瞐
瞑	瞑
瞒	瞒
瞓	瞓
瞔	瞔
瞕	瞕
瞖	瞖
瞗	瞗
瞘	眍
瞙	瞙
瞚	瞚
瞛	瞛
瞜	瞜
瞝	瞝
瞞	瞒
瞟	瞟
瞠	瞠
瞡	瞡
瞢	瞢
瞣	瞣
瞤	瞤
瞥	瞥
瞦	瞦
瞧	瞧
瞨	瞨
瞩	瞩
瞪	瞪
瞫	瞫
瞬	瞬
瞭	瞭
瞮	瞮
瞯	瞯
瞰	瞰
瞱	瞱
瞲	瞲
瞳	瞳
瞴	瞴
瞵	瞵
瞶	瞆
瞷	瞷
瞸	瞸
瞹	瞹
瞺	瞺
瞻	瞻
瞼	睑
瞽	瞽
瞾	瞾
瞿	瞿
矀	矀
矁	矁
矂	矂
矃	矃
矄	矄
矅	矅
矆	矆
矇	矇
矈	矈
矉	矉
矊	矊
矋	矋
矌	矌
矍	矍
矎	矎
矏	矏
矐	矐
矑	矑
矒	矒
矓	眬
矔	矔
矕	矕
矖	矖
矗	矗
矘	矘
矙	矙
矚	瞩
矛	矛
矜	矜
矝	矝
矞	矞
矟	矟
矠	矠
矡	矡
矢	矢
矣	矣
矤	矤
知	知
矦	矦
矧	矧
矨	矨
矩	矩
矪	矪
矫	矫
矬	矬
短	短
矮	矮
矯	矫
矰	矰
矱	矱
矲	矲
石	石
矴	矴
矵	矵
矶	矶
矷	矷
矸	矸
矹	矹
矺	矺
矻	矻
矼	矼
矽	矽
矾	矾
矿	矿
砀	砀
码	码
砂	砂
砃	砃
砄	砄
砅	砅
砆	砆
砇	砇
砈	砈
砉	砉
砊	砊
砋	砋
砌	砌
砍	砍
砎	砎
砏	砏
砐	砐
砑	砑
砒	砒
砓	砓
研	研
砕	砕
砖	砖
砗	砗
砘	砘
砙	砙
砚	砚
砛	砛
砜	砜
砝	砝
砞	砞
砟	砟
砠	砠
砡	砡
砢	砢
砣	砣
砤	砤
砥	砥
砦	砦
砧	砧
砨	砨
砩	砩
砪	砪
砫	砫
砬	砬
砭	砭
砮	砮
砯	砯
砰	砰
砱	砱
砲	砲
砳	砳
破	破
砵	砵
砶	砶
砷	砷
砸	砸
砹	砹
砺	砺
砻	砻
砼	砼
砽	砽
砾	砾
砿	砿
础	础
硁	硁
硂	硂
硃	硃
硄	硄
硅	硅
硆	硆
硇	硇
硈	硈
硉	硉
硊	硊
硋	硋
硌	硌
硍	硍
硎	硎
硏	硏
硐	硐
硑	硑
硒	硒
硓	硓
硔	硔
硕	硕
硖	硖
硗	硗
硘	硘
硙	硙
硚	硚
硛	硛
硜	硁
硝	硝
硞	硞
硟	硟
硠	硠
硡	硡
硢	硢
硣	硣
硤	硖
硥	硥
硦	硦
硧	硧
硨	砗
硩	硩
硪	硪
硫	硫
硬	硬
硭	硭
确	确
硯	砚
硰	硰
硱	硱
硲	硲
硳	硳
硴	硴
硵	硵
硶	硶
硷	硷
硸	硸
硹	硹
硺	硺
硻	硻
硼	硼
硽	硽
硾	硾
硿	硿
碀	碀
碁	碁
碂	碂
碃	碃
碄	碄
碅	碅
碆	碆
碇	碇
碈	碈
碉	碉
碊	碊
碋	碋
碌	碌
碍	碍
碎	碎
碏	碏
碐	碐
碑	碑
碒	碒
碓	碓
碔	碔
碕	碕
碖	碖
碗	碗
碘	碘
碙	碙
碚	碚
碛	碛
碜	碜
碝	碝
碞	碞
碟	碟
碠	碠
碡	碡
碢	碢
碣	碣
碤	碤
碥	碥
碦	碦
碧	碧
碨	碨
碩	硕
碪	碪
碫	碫
碬	碬
碭	砀
碮	碮
碯	碯
碰	碰
碱	碱
碲	碲
碳	碳
碴	碴
碵	碵
碶	碶
碷	碷
碸	砜
碹	碹
確	确
碻	碻
碼	码
碽	碽
碾	碾
碿	碿
磀	磀
磁	磁
磂	磂
磃	磃
磄	磄
磅	磅
磆	磆
磇	磇
磈	磈
磉	磉
磊	磊
磋	磋
磌	磌
磍	磍
磎	磎
磏	磏
磐	磐
磑	硙
磒	磒
磓	磓
磔	磔
磕	磕
磖	磖
磗	磗
磘	磘
磙	磙
磚	砖
磛	磛
磜	磜
磝	磝
磞	磞
磟	磟
磠	硵
磡	磡
磢	磢
磣	碜
磤	磤
磥	磥
磦	磦
磧	碛
磨	磨
磩	磩
磪	磪
磫	磫
磬	磬
磭	磭
磮	磮
磯	矶
磰	磰
磱	磱
磲	磲
磳	磳
磴	磴
磵	磵
磶	磶
磷	磷
磸	磸
磹	磹
磺	磺
磻	磻
磼	磼
磽	硗
磾	磾
磿	磿
礀	礀
礁	礁
礂	礂
礃	礃
礄	硚
礅	礅
礆	硷
礇	礇
礈	礈
礉	礉
礊	礊
礋	礋
礌	礌
礍	礍
礎	础
礏	礏
礐	礐
礑	礑
礒	礒
礓	礓
礔	礔
礕	礕
礖	礖
礗	礗
礘	礘
礙	碍
礚	礚
礛	礛
礜	礜
礝	礝
礞	礞
礟	礟
礠	礠
礡	礡
礢	礢
礣	礣
礤	礤
礥	礥
礦	矿
礧	礧
礨	礨
礩	礩
礪	砺
礫	砾
礬	矾
礭	礭
礮	礮
礯	礯
礰	礰
礱	砻
礲	礲
礳	礳
礴	礴
礵	礵
礶	礶
礷	礷
礸	礸
礹	礹
示	示
礻	礻
礼	礼
礽	礽
社	社
礿	礿
祀	祀
祁	祁
祂	祂
祃	祃
祄	祄
祅	祅
祆	祆
祇	祇
祈	祈
祉	祉
祊	祊
祋	祋
祌	祌
祍	祍
祎	祎
祏	祏
祐	祐
祑	祑
祒	祒
祓	祓
祔	祔
祕	祕
祖	祖
祗	祗
祘	祘
祙	祙
祚	祚
祛	祛
祜	祜
祝	祝
神	神
祟	祟
祠	祠
祡	祡
祢	祢
祣	祣
祤	祤
祥	祥
祦	祦
祧	祧
票	票
祩	祩
祪	祪
祫	祫
祬	祬
祭	祭
祮	祮
祯	祯
祰	祰
祱	祱
祲	祲
祳	祳
祴	祴
祵	祵
祶	祶
祷	祷
祸	祸
祹	祹
祺	祺
祻	祻
祼	祼
祽	祽
祾	祾
祿	禄
禀	禀
禁	禁
禂	禂
禃	禃
禄	禄
禅	禅
禆	禆
禇	禇
禈	禈
禉	禉
禊	禊
禋	禋
禌	禌
禍	祸
禎	祯
福	福
禐	禐
禑	禑
禒	禒
禓	禓
禔	禔
禕	祎
禖	禖
禗	禗
禘	禘
禙	禙
禚	禚
禛	禛
禜	禜
禝	禝
禞	禞
禟	禟
禠	禠
禡	祃
禢	禢
禣	禣
禤	禤
禥	禥
禦	御
禧	禧
禨	禨
禩	禩
禪	禅
禫	禫
禬	禬
禭	禭
禮	礼
禯	禯
禰	祢
禱	祷
禲	禲
禳	禳
禴	禴
禵	禵
禶	禶
禷	禷
禸	禸
禹	禹
禺	禺
离	离
禼	禼
禽	禽
禾	禾
禿	秃
秀	秀
私	私
秂	秂
秃	秃
秄	秄
秅	秅
秆	秆
秇	秇
秈	籼
秉	秉
秊	秊
秋	秋
秌	秌
种	种
秎	秎
秏	秏
秐	秐
科	科
秒	秒
秓	秓
秔	秔
秕	秕
秖	秖
秗	秗
秘	秘
秙	秙
秚	秚
秛	秛
秜	秜
秝	秝
秞	秞
租	租
秠	秠
秡	秡
秢	秢
秣	秣
秤	秤
秥	秥
秦	秦
秧	秧
秨	秨
秩	秩
秪	秪
秫	秫
秬	秬
秭	秭
秮	秮
积	积
称	称
秱	秱
秲	秲
秳	秳
秴	秴
秵	秵
秶	秶
秷	秷
秸	秸
秹	秹
秺	秺
移	移
秼	秼
秽	秽
秾	秾
秿	秿
稀	稀
稁	稁
稂	稂
稃	稃
稄	稄
稅	税
稆	稆
稇	稇
稈	秆
稉	稉
稊	稊
程	程
稌	稌
稍	稍
税	税
稏	稏
稐	稐
稑	稑
稒	稒
稓	稓
稔	稔
稕	稕
稖	稖
稗	稗
稘	稘
稙	稙
稚	稚
稛	稛
稜	稜
稝	稝
稞	稞
稟	禀
稠	稠
稡	稡
稢	稢
稣	稣
稤	稤
稥	稥
稦	稦
稧	稧
稨	稨
稩	稩
稪	稪
稫	稫
稬	稬
稭	稭
種	种
稯	稯
稰	稰
稱	称
稲	稲
稳	稳
稴	稴
稵	稵
稶	稶
稷	稷
稸	稸
稹	稹
稺	稺
稻	稻
稼	稼
稽	稽
稾	稾
稿	稿
穀	谷
穁	穁
穂	穂
穃	穃
穄	穄
穅	穅
穆	穆
穇	穇
穈	穈
穉	穉
穊	穊
穋	穋
穌	稣
積	积
穎	颖
穏	穏
穐	穐
穑	穑
穒	穒
穓	穓
穔	穔
穕	穕
穖	穖
穗	穗
穘	穘
穙	穙
穚	穚
穛	穛
穜	穜
穝	穝
穞	穞
穟	穟
穠	秾
穡	穑
穢	秽
穣	穣
穤	穤
穥	穥
穦	穦
穧	穧
穨	穨
穩	稳
穪	穪
穫	获
穬	穬
穭	稆
穮	穮
穯	穯
穰	穰
穱	穱
穲	穲
穳	穳
穴	穴
穵	穵
究	究
穷	穷
穸	穸
穹	穹
空	空
穻	穻
穼	穼
穽	穽
穾	穾
穿	穿
窀	窀
突	突
窂	窂
窃	窃
窄	窄
窅	窅
窆	窆
窇	窇
窈	窈
窉	窉
窊	窊
窋	窋
窌	窌
窍	窍
窎	窎
窏	窏
窐	窐
窑	窑
窒	窒
窓	窓
窔	窔
窕	窕
窖	窖
窗	窗
窘	窘
窙	窙
窚	窚
窛	窛
窜	窜
窝	窝
窞	窞
窟	窟
窠	窠
窡	窡
窢	窢
窣	窣
窤	窤
窥	窥
窦	窦
窧	窧
窨	窨
窩	窝
窪	洼
窫	窫
窬	窬
窭	窭
窮	穷
窯	窑
窰	窰
窱	窱
窲	窲
窳	窳
窴	窴
窵	窎
窶	窭
窷	窷
窸	窸
窹	窹
窺	窥
窻	窻
窼	窼
窽	窽
窾	窾
窿	窿
竀	竀
竁	竁
竂	竂
竃	竃
竄	窜
竅	窍
竆	竆
竇	窦
竈	竈
竉	竉
竊	窃
立	立
竌	竌
竍	竍
竎	竎
竏	竏
竐	竐
竑	竑
竒	竒
竓	竓
竔	竔
竕	竕
竖	竖
竗	竗
竘	竘
站	站
竚	竚
竛	竛
竜	竜
竝	竝
竞	竞
竟	竟
章	章
竡	竡
竢	竢
竣	竣
竤	竤
童	童
竦	竦
竧	竧
竨	竨
竩	竩
竪	竪
竫	竫
竬	竬
竭	竭
竮	竮
端	端
竰	竰
竱	竱
竲	竲
竳	竳
竴	竴
竵	竵
競	竞
竷	竷
竸	竸
竹	竹
竺	竺
竻	竻
竼	竼
竽	竽
竾	竾
竿	竿
笀	笀
笁	笁
笂	笂
笃	笃
笄	笄
笅	笅
笆	笆
笇	笇
笈	笈
笉	笉
笊	笊
笋	笋
笌	笌
笍	笍
笎	笎
笏	笏
笐	笐
笑	笑
笒	笒
笓	笓
笔	笔
笕	笕
笖	笖
笗	笗
笘	笘
笙	笙
笚	笚
笛	笛
笜	笜
笝	笝
笞	笞
笟	笟
笠	笠
笡	笡
笢	笢
笣	笣
笤	笤
笥	笥
符	符
笧	笧
笨	笨
笩	笩
笪	笪
笫	笫
第	第
笭	笭
笮	笮
笯	笯
笰	笰
笱	笱
笲	笲
笳	笳
笴	笴
笵	笵
笶	笶
笷	笷
笸	笸
笹	笹
笺	笺
笻	笻
笼	笼
笽	笽
笾	笾
笿	笿
筀	筀
筁	筁
筂	筂
筃	筃
筄	筄
筅	筅
筆	笔
筇	筇
筈	筈
等	等
筊	筊
筋	筋
筌	筌
筍	笋
筎	筎
筏	筏
筐	筐
筑	筑
筒	筒
筓	筓
答	答
筕	筕
策	策
筗	筗
筘	筘
筙	筙
筚	筚
筛	筛
筜	筜
筝	筝
筞	筞
筟	筟
筠	筠
筡	筡
筢	筢
筣	筣
筤	筤
筥	筥
筦	筦
筧	笕
筨	筨
筩	筩
筪	筪
筫	筫
筬	筬
筭	筭
筮	筮
筯	筯
筰	筰
筱	筱
筲	筲
筳	筳
筴	筴
筵	筵
筶	筶
筷	筷
筸	筸
筹	筹
筺	筺
筻	筻
筼	筼
筽	筽
签	签
筿	筿
简	简
箁	箁
箂	箂
箃	箃
箄	箄
箅	箅
箆	箆
箇	箇
箈	箈
箉	箉
箊	箊
箋	笺
箌	箌
箍	箍
箎	箎
箏	筝
箐	箐
箑	箑
箒	箒
箓	箓
箔	箔
箕	箕
箖	箖
算	算
箘	箘
箙	箙
箚	箚
箛	箛
箜	箜
箝	箝
箞	箞
箟	箟
箠	箠
管	管
箢	箢
箣	箣
箤	箤
箥	箥
箦	箦
箧	箧
箨	箨
箩	箩
箪	箪
箫	箫
箬	箬
箭	箭
箮	箮
箯	箯
箰	箰
箱	箱
箲	箲
箳	箳
箴	箴
箵	箵
箶	箶
箷	箷
箸	箸
箹	箹
箺	箺
箻	箻
箼	箼
箽	箽
箾	箾
箿	箿
節	节
篁	篁
篂	篂
篃	篃
範	范
篅	篅
篆	篆
篇	篇
篈	篈
築	筑
篊	篊
篋	箧
篌	篌
篍	篍
篎	篎
篏	篏
篐	篐
篑	篑
篒	篒
篓	篓
篔	筼
篕	篕
篖	篖
篗	篗
篘	篘
篙	篙
篚	篚
篛	篛
篜	篜
篝	篝
篞	篞
篟	篟
篠	篠
篡	篡
篢	篢
篣	篣
篤	笃
篥	篥
篦	篦
篧	篧
篨	篨
篩	筛
篪	篪
篫	篫
篬	篬
篭	篭
篮	篮
篯	篯
篰	篰
篱	篱
篲	篲
篳	筚
篴	篴
篵	篵
篶	篶
篷	篷
篸	篸
篹	篹
篺	篺
篻	篻
篼	篼
篽	篽
篾	篾
篿	篿
簀	箦
簁	簁
簂	簂
簃	簃
簄	簄
簅	簅
簆	簆
簇	簇
簈	簈
簉	簉
簊	簊
簋	簋
簌	簌
簍	篓
簎	簎
簏	簏
簐	簐
簑	簑
簒	簒
簓	簓
簔	簔
簕	簕
簖	簖
簗	簗
簘	簘
簙	簙
簚	簚
簛	簛
簜	簜
簝	簝
簞	箪
簟	簟
簠	簠
簡	简
簢	簢
簣	篑
簤	簤
簥	簥
簦	簦
簧	簧
簨	簨
簩	簩
簪	簪
簫	箫
簬	簬
簭	簭
簮	簮
簯	簯
簰	簰
簱	簱
簲	簲
簳	簳
簴	簴
簵	簵
簶	簶
簷	簷
簸	簸
簹	筜
簺	簺
簻	簻
簼	簼
簽	签
簾	帘
簿	簿
籀	籀
籁	籁
籂	籂
籃	篮
籄	籄
籅	籅
籆	籆
籇	籇
籈	籈
籉	籉
籊	籊
籋	籋
籌	筹
籍	籍
籎	籎
籏	籏
籐	籐
籑	籑
籒	籒
籓	籓
籔	籔
籕	籕
籖	籖
籗	籗
籘	籘
籙	箓
籚	籚
籛	篯
籜	箨
籝	籝
籞	籞
籟	籁
籠	笼
籡	籡
籢	籢
籣	籣
籤	籤
籥	籥
籦	籦
籧	籧
籨	籨
籩	笾
籪	簖
籫	籫
籬	篱
籭	籭
籮	箩
籯	籯
籰	籰
籱	籱
籲	籲
米	米
籴	籴
籵	籵
籶	籶
籷	籷
籸	籸
籹	籹
籺	籺
类	类
籼	籼
籽	籽
籾	籾
籿	籿
粀	粀
粁	粁
粂	粂
粃	粃
粄	粄
粅	粅
粆	粆
粇	粇
粈	粈
粉	粉
粊	粊
粋	粋
粌	粌
粍	粍
粎	粎
粏	粏
粐	粐
粑	粑
粒	粒
粓	粓
粔	粔
粕	粕
粖	粖
粗	粗
粘	粘
粙	粙
粚	粚
粛	粛
粜	粜
粝	粝
粞	粞
粟	粟
粠	粠
粡	粡
粢	粢
粣	粣
粤	粤
粥	粥
粦	粦
粧	粧
粨	粨
粩	粩
粪	粪
粫	粫
粬	粬
粭	粭
粮	粮
粯	粯
粰	粰
粱	粱
粲	粲
粳	粳
粴	粴
粵	粤
粶	粶
粷	粷
粸	粸
粹	粹
粺	粺
粻	粻
粼	粼
粽	粽
精	精
粿	粿
糀	糀
糁	糁
糂	糂
糃	糃
糄	糄
糅	糅
糆	糆
糇	糇
糈	糈
糉	糉
糊	糊
糋	糋
糌	糌
糍	糍
糎	糎
糏	糏
糐	糐
糑	糑
糒	糒
糓	糓
糔	糔
糕	糕
糖	糖
糗	糗
糘	糘
糙	糙
糚	糚
糛	糛
糜	糜
糝	糁
糞	粪
糟	糟
糠	糠
糡	糡
糢	糢
糣	糣
糤	糤
糥	糥
糦	糦
糧	粮
糨	糨
糩	糩
糪	糪
糫	糫
糬	糬
糭	糭
糮	糮
糯	糯
糰	糰
糱	糱
糲	粝
糳	糳
糴	籴
糵	糵
糶	粜
糷	糷
糸	糸
糹	纟
糺	糺
系	系
糼	糼
糽	糽
糾	纠
糿	糿
紀	纪
紁	紁
紂	纣
紃	紃
約	约
紅	红
紆	纡
紇	纥
紈	纨
紉	纫
紊	紊
紋	纹
紌	紌
納	纳
紎	紎
紏	紏
紐	纽
紑	紑
紒	紒
紓	纾
純	纯
紕	纰
紖	纼
紗	纱
紘	纮
紙	纸
級	级
紛	纷
紜	纭
紝	纴
紞	紞
紟	紟
素	素
紡	纺
索	索
紣	紣
紤	紤
紥	紥
紦	紦
紧	紧
紨	紨
紩	紩
紪	紪
紫	紫
紬	紬
紭	紭
紮	紮
累	累
細	细
紱	绂
紲	绁
紳	绅
紴	紴
紵	纻
紶	紶
紷	紷
紸	紸
紹	绍
紺	绀
紻	紻
紼	绋
紽	紽
紾	紾
紿	绐
絀	绌
絁	絁
終	终
絃	絃
組	组
絅	絅
絆	绊
絇	絇
絈	絈
絉	絉
絊	絊
絋	絋
経	経
絍	絍
絎	绗
絏	絏
結	结
絑	絑
絒	絒
絓	絓
絔	絔
絕	绝
絖	絖
絗	絗
絘	絘
絙	絙
絚	絚
絛	绦
絜	絜
絝	绔
絞	绞
絟	絟
絠	絠
絡	络
絢	绚
絣	絣
絤	絤
絥	絥
給	给
絧	絧
絨	绒
絩	絩
絪	絪
絫	絫
絬	絬
絭	絭
絮	絮
絯	絯
絰	绖
統	统
絲	丝
絳	绛
絴	絴
絵	絵
絶	絶
絷	絷
絸	絸
絹	绢
絺	絺
絻	絻
絼	絼
絽	絽
絾	絾
絿	絿
綀	綀
綁	绑
綂	綂
綃	绡
綄	綄
綅	綅
綆	绠
綇	綇
綈	绨
綉	綉
綊	綊
綋	綋
綌	绤
綍	綍
綎	綎
綏	绥
綐	綐
綑	綑
綒	綒
經	经
綔	綔
綕	綕
綖	綖
綗	綗
綘	綘
継	継
続	続
綛	綛
綜	综
綝	綝
綞	缍
綟	綟
綠	绿
綡	綡
綢	绸
綣	绻
綤	綤
綥	綥
綦	綦
綧	綧
綨	綨
綩	綩
綪	綪
綫	綫
綬	绶
維	维
綮	綮
綯	绹
綰	绾
綱	纲
網	网
綳	綳
綴	缀
綵	綵
綶	綶
綷	綷
綸	纶
綹	绺
綺	绮
綻	绽
綼	綼
綽	绰
綾	绫
綿	绵
緀	緀
緁	緁
緂	緂
緃	緃
緄	绲
緅	緅
緆	緆
緇	缁
緈	緈
緉	緉
緊	紧
緋	绯
緌	緌
緍	緍
緎	緎
総	総
緐	緐
緑	緑
緒	绪
緓	绬
緔	緔
緕	緕
緖	緖
緗	缃
緘	缄
緙	缂
線	线
緛	緛
緜	緜
緝	缉
緞	缎
緟	緟
締	缔
緡	缗
緢	緢
緣	缘
緤	緤
緥	緥
緦	缌
緧	緧
編	编
緩	缓
緪	緪
緫	緫
緬	缅
緭	緭
緮	緮
緯	纬
緰	緰
緱	缑
緲	缈
緳	緳
練	练
緵	緵
緶	缏
緷	緷
緸	緸
緹	缇
緺	緺
緻	致
緼	緼
緽	緽
緾	緾
緿	緿
縀	縀
縁	縁
縂	縂
縃	縃
縄	縄
縅	縅
縆	縆
縇	縇
縈	萦
縉	缙
縊	缢
縋	缒
縌	縌
縍	縍
縎	縎
縏	縏
縐	绉
縑	缣
縒	縒
縓	縓
縔	縔
縕	缊
縖	縖
縗	缞
縘	縘
縙	縙
縚	縚
縛	缚
縜	縜
縝	缜
縞	缟
縟	缛
縠	縠
縡	縡
縢	縢
縣	县
縤	縤
縥	縥
縦	縦
縧	縧
縨	縨
縩	縩
縪	縪
縫	缝
縬	縬
縭	缡
縮	缩
縯	縯
縰	縰
縱	纵
縲	缧
縳	縳
縴	縴
縵	缦
縶	絷
縷	缕
縸	縸
縹	缥
縺	縺
縻	縻
縼	縼
總	总
績	绩
縿	縿
繀	繀
繁	繁
繂	繂
繃	绷
繄	繄
繅	缫
繆	缪
繇	繇
繈	繈
繉	繉
繊	繊
繋	繋
繌	繌
繍	繍
繎	繎
繏	繏
繐	繐
繑	繑
繒	缯
繓	繓
織	织
繕	缮
繖	繖
繗	繗
繘	繘
繙	繙
繚	缭
繛	繛
繜	繜
繝	繝
繞	绕
繟	繟
繠	繠
繡	绣
繢	缋
繣	繣
繤	繤
繥	繥
繦	繦
繧	繧
繨	繨
繩	绳
繪	绘
繫	系
繬	繬
繭	茧
繮	繮
繯	缳
繰	缲
繱	繱
繲	繲
繳	缴
繴	繴
繵	繵
繶	繶
繷	繷
繸	繸
繹	绎
繺	繺
繻	繻
繼	继
繽	缤
繾	缱
繿	繿
纀	纀
纁	纁
纂	纂
纃	纃
纄	纄
纅	纅
纆	纆
纇	颣
纈	缬
纉	纉
纊	纩
纋	纋
續	续
纍	累
纎	纎
纏	缠
纐	纐
纑	纑
纒	纒
纓	缨
纔	纔
纕	纕
纖	纤
纗	纗
纘	缵
纙	纙
纚	纚
纛	纛
纜	缆
纝	纝
纞	纞
纟	纟
纠	纠
纡	纡
红	红
纣	纣
纤	纤
纥	纥
约	约
级	级
纨	纨
纩	纩
纪	纪
纫	纫
纬	纬
纭	纭
纮	纮
纯	纯
纰	纰
纱	纱
纲	纲
纳	纳
纴	纴
纵	纵
纶	纶
纷	纷
纸	纸
纹	纹
纺	纺
纻	纻
纼	纼
纽	纽
纾	纾
线	线
绀	绀
绁	绁
绂	绂
练	练
组	组
绅	绅
细	细
织	织
终	终
绉	绉
绊	绊
绋	绋
绌	绌
绍	绍
绎	绎
经	经
绐	绐
绑	绑
绒	绒
结	结
绔	绔
绕	绕
绖	绖
绗	绗
绘	绘
给	给
绚	绚
绛	绛
络	络
绝	绝
绞	绞
统	统
绠	绠
绡	绡
绢	绢
绣	绣
绤	绤
绥	绥
绦	绦
继	继
绨	绨
绩	绩
绪	绪
绫	绫
绬	绬
续	续
绮	绮
绯	绯
绰	绰
绱	绱
绲	绲
绳	绳
维	维
绵	绵
绶	绶
绷	绷
绸	绸
绹	绹
绺	绺
绻	绻
综	综
绽	绽
绾	绾
绿	绿
缀	缀
缁	缁
缂	缂
缃	缃
缄	缄
缅	缅
缆	缆
缇	缇
缈	缈
缉	缉
缊	缊
缋	缋
缌	缌
缍	缍
缎	缎
缏	缏
缐	缐
缑	缑
缒	缒
缓	缓
缔	缔
缕	缕
编	编
缗	缗
缘	缘
缙	缙
缚	缚
缛	缛
缜	缜
缝	缝
缞	缞
缟	缟
缠	缠
缡	缡
缢	缢
缣	缣
缤	缤
缥	缥
缦	缦
缧	缧
缨	缨
缩	缩
缪	缪
缫	缫
缬	缬
缭	缭
缮	缮
缯	缯
缰	缰
缱	缱
缲	缲
缳	缳
缴	缴
缵	缵
缶	缶
缷	缷
缸	缸
缹	缹
缺	缺
缻	缻
缼	缼
缽	钵
缾	缾
缿	缿
罀	罀
罁	罁
罂	罂
罃	罃
罄	罄
罅	罅
罆	罆
罇	罇
罈	坛
罉	罉
罊	罊
罋	罋
罌	罂
罍	罍
罎	罎
罏	罏
罐	罐
网	网
罒	罒
罓	罓
罔	罔
罕	罕
罖	罖
罗	罗
罘	罘
罙	罙
罚	罚
罛	罛
罜	罜
罝	罝
罞	罞
罟	罟
罠	罠
罡	罡
罢	罢
罣	罣
罤	罤
罥	罥
罦	罦
罧	罧
罨	罨
罩	罩
罪	罪
罫	罫
罬	罬
罭	罭
置	置
罯	罯
罰	罚
罱	罱
署	署
罳	罳
罴	罴
罵	骂
罶	罶
罷	罢
罸	罸
罹	罹
罺	罺
罻	罻
罼	罼
罽	罽
罾	罾
罿	罿
羀	羀
羁	羁
羂	羂
羃	羃
羄	羄
羅	罗
羆	罴
羇	羇
羈	羁
羉	羉
羊	羊
羋	芈
羌	羌
羍	羍
美	美
羏	羏
羐	羐
羑	羑
羒	羒
羓	羓
羔	羔
羕	羕
羖	羖
羗	羗
羘	羘
羙	羙
羚	羚
羛	羛
羜	羜
羝	羝
羞	羞
羟	羟
羠	羠
羡	羡
羢	羢
羣	羣
群	群
羥	羟
羦	羦
羧	羧
羨	羨
義	义
羪	羪
羫	羫
羬	羬
羭	羭
羮	羮
羯	羯
羰	羰
羱	羱
羲	羲
羳	羳
羴	羴
羵	羵
羶	羶
羷	羷
羸	羸
羹	羹
羺	羺
羻	羻
羼	羼
羽	羽
羾	羾
羿	羿
翀	翀
翁	翁
翂	翂
翃	翃
翄	翄
翅	翅
翆	翆
翇	翇
翈	翈
翉	翉
翊	翊
翋	翋
翌	翌
翍	翍
翎	翎
翏	翏
翐	翐
翑	翑
習	习
翓	翓
翔	翔
翕	翕
翖	翖
翗	翗
翘	翘
翙	翙
翚	翚
翛	翛
翜	翜
翝	翝
翞	翞
翟	翟
翠	翠
翡	翡
翢	翢
翣	翣
翤	翤
翥	翥
翦	翦
翧	翧
翨	翨
翩	翩
翪	翪
翫	翫
翬	翚
翭	翭
翮	翮
翯	翯
翰	翰
翱	翱
翲	翲
翳	翳
翴	翴
翵	翵
翶	翶
翷	翷
翸	翸
翹	翘
翺	翺
翻	翻
翼	翼
翽	翙
翾	翾
翿	翿
耀	耀
老	老
耂	耂
考	考
耄	耄
者	者
耆	耆
耇	耇
耈	耈
耉	耉
耊	耊
耋	耋
而	而
耍	耍
耎	耎
耏	耏
耐	耐
耑	耑
耒	耒
耓	耓
耔	耔
耕	耕
耖	耖
耗	耗
耘	耘
耙	耙
耚	耚
耛	耛
耜	耜
耝	耝
耞	耞
耟	耟
耠	耠
耡	耡
耢	耢
耣	耣
耤	耤
耥	耥
耦	耦
耧	耧
耨	耨
耩	耩
耪	耪
耫	耫
耬	耧
耭	耭
耮	耢
耯	耯
耰	耰
耱	耱
耲	耲
耳	耳
耴	耴
耵	耵
耶	耶
耷	耷
耸	耸
耹	耹
耺	耺
耻	耻
耼	耼
耽	耽
耾	耾
耿	耿
聀	聀
聁	聁
聂	聂
聃	聃
聄	聄
聅	聅
聆	聆
聇	聇
聈	聈
聉	聉
聊	聊
聋	聋
职	职
聍	聍
聎	聎
聏	聏
聐	聐
聑	聑
聒	聒
聓	聓
联	联
聕	聕
聖	圣
聗	聗
聘	聘
聙	聙
聚	聚
聛	聛
聜	聜
聝	聝
聞	闻
聟	聟
聠	聠
聡	聡
聢	聢
聣	聣
聤	聤
聥	聥
聦	聦
聧	聧
聨	聨
聩	聩
聪	聪
聫	聫
聬	聬
聭	聭
聮	聮
聯	联
聰	聪
聱	聱
聲	声
聳	耸
聴	聴
聵	聩
聶	聂
職	职
聸	聸
聹	聍
聺	聺
聻	聻
聼	聼
聽	听
聾	聋
聿	聿
肀	肀
肁	肁
肂	肂
肃	肃
肄	肄
肅	肃
肆	肆
肇	肇
肈	肈
肉	肉
肊	肊
肋	肋
肌	肌
肍	肍
肎	肎
肏	肏
肐	肐
肑	肑
肒	肒
肓	肓
肔	肔
肕	肕
肖	肖
肗	肗
肘	肘
肙	肙
肚	肚
肛	肛
肜	肜
肝	肝
肞	肞
肟	肟
肠	肠
股	股
肢	肢
肣	肣
肤	肤
肥	肥
肦	肦
肧	肧
肨	肨
肩	肩
肪	肪
肫	肫
肬	肬
肭	肭
肮	肮
肯	肯
肰	肰
肱	肱
育	育
肳	肳
肴	肴
肵	肵
肶	肶
肷	肷
肸	肸
肹	肹
肺	肺
肻	肻
肼	肼
肽	肽
肾	肾
肿	肿
胀	胀
胁	胁
胂	胂
胃	胃
胄	胄
胅	胅
胆	胆
胇	胇
胈	胈
胉	胉
胊	胊
胋	胋
背	背
胍	胍
胎	胎
胏	胏
胐	胐
胑	胑
胒	胒
胓	胓
胔	胔
胕	胕
胖	胖
胗	胗
胘	胘
胙	胙
胚	胚
胛	胛
胜	胜
胝	胝
胞	胞
胟	胟
胠	胠
胡	胡
胢	胢
胣	胣
胤	胤
胥	胥
胦	胦
胧	胧
胨	胨
胩	胩
胪	胪
胫	胫
胬	胬
胭	胭
胮	胮
胯	胯
胰	胰
胱	胱
胲	胲
胳	胳
胴	胴
胵	胵
胶	胶
胷	胷
胸	胸
胹	胹
胺	胺
胻	胻
胼	胼
能	能
胾	胾
胿	胿
脀	脀
脁	脁
脂	脂
脃	脃
脄	脄
脅	胁
脆	脆
脇	脇
脈	脉
脉	脉
脊	脊
脋	脋
脌	脌
脍	脍
脎	脎
脏	脏
脐	脐
脑	脑
脒	脒
脓	脓
脔	脔
脕	脕
脖	脖
脗	脗
脘	脘
脙	脙
脚	脚
脛	胫
脜	脜
脝	脝
脞	脞
脟	脟
脠	脠
脡	脡
脢	脢
脣	脣
脤	脤
脥	脥
脦	脦
脧	脧
脨	脨
脩	脩
脪	脪
脫	脱
脬	脬
脭	脭
脮	脮
脯	脯
脰	脰
脱	脱
脲	脲
脳	脳
脴	脴
脵	脵
脶	脶
脷	脷
脸	脸
脹	胀
脺	脺
脻	脻
脼	脼
脽	脽
脾	脾
脿	脿
腀	腀
腁	腁
腂	腂
腃	腃
腄	腄
腅	腅
腆	腆
腇	腇
腈	腈
腉	腉
腊	腊
腋	腋
腌	腌
腍	腍
腎	肾
腏	腏
腐	腐
腑	腑
腒	腒
腓	腓
腔	腔
腕	腕
腖	胨
腗	腗
腘	腘
腙	腙
腚	腚
腛	腛
腜	腜
腝	腝
腞	腞
腟	腟
腠	腠
腡	脶
腢	腢
腣	腣
腤	腤
腥	腥
腦	脑
腧	腧
腨	腨
腩	腩
腪	腪
腫	肿
腬	腬
腭	腭
腮	腮
腯	腯
腰	腰
腱	腱
腲	腲
腳	脚
腴	腴
腵	腵
腶	腶
腷	腷
腸	肠
腹	腹
腺	腺
腻	腻
腼	腼
腽	腽
腾	腾
腿	腿
膀	膀
膁	膁
膂	膂
膃	腽
膄	膄
膅	膅
膆	膆
膇	膇
膈	膈
膉	膉
膊	膊
膋	膋
膌	膌
膍	膍
膎	膎
膏	膏
膐	膐
膑	膑
膒	膒
膓	膓
膔	膔
膕	腘
膖	膖
膗	膗
膘	膘
膙	膙
膚	肤
膛	膛
膜	膜
膝	膝
膞	膞
膟	膟
膠	胶
膡	膡
膢	膢
膣	膣
膤	膤
膥	膥
膦	膦
膧	膧
膨	膨
膩	腻
膪	膪
膫	膫
膬	膬
膭	膭
膮	膮
膯	膯
膰	膰
膱	膱
膲	膲
膳	膳
膴	膴
膵	膵
膶	膶
膷	膷
膸	膸
膹	膹
膺	膺
膻	膻
膼	膼
膽	胆
膾	脍
膿	脓
臀	臀
臁	臁
臂	臂
臃	臃
臄	臄
臅	臅
臆	臆
臇	臇
臈	臈
臉	脸
臊	臊
臋	臋
臌	臌
臍	脐
臎	臎
臏	膑
臐	臐
臑	臑
臒	臒
臓	臓
臔	臔
臕	臕
臖	臖
臗	臗
臘	腊
臙	臙
臚	胪
臛	臛
臜	臜
臝	臝
臞	臞
臟	脏
臠	脔
臡	臡
臢	臜
臣	臣
臤	臤
臥	臥
臦	臦
臧	臧
臨	临
臩	臩
自	自
臫	臫
臬	臬
臭	臭
臮	臮
臯	臯
臰	臰
臱	臱
臲	臲
至	至
致	致
臵	臵
臶	臶
臷	臷
臸	臸
臹	臹
臺	台
臻	臻
臼	臼
臽	臽
臾	臾
臿	臿
舀	舀
舁	舁
舂	舂
舃	舃
舄	舄
舅	舅
舆	舆
與	与
興	兴
舉	举
舊	旧
舋	舋
舌	舌
舍	舍
舎	舎
舏	舏
舐	舐
舑	舑
舒	舒
舓	舓
舔	舔
舕	舕
舖	舖
舗	舗
舘	舘
舙	舙
舚	舚
舛	舛
舜	舜
舝	舝
舞	舞
舟	舟
舠	舠
舡	舡
舢	舢
舣	舣
舤	舤
舥	舥
舦	舦
舧	舧
舨	舨
舩	舩
航	航
舫	舫
般	般
舭	舭
舮	舮
舯	舯
舰	舰
舱	舱
舲	舲
舳	舳
舴	舴
舵	舵
舶	舶
舷	舷
舸	舸
船	船
舺	舺
舻	舻
舼	舼
舽	舽
舾	舾
舿	舿
艀	艀
艁	艁
艂	艂
艃	艃
艄	艄
艅	艅
艆	艆
艇	艇
艈	艈
艉	艉
艊	艊
艋	艋
艌	艌
艍	艍
艎	艎
艏	艏
艐	艐
艑	艑
艒	艒
艓	艓
艔	艔
艕	艕
艖	艖
艗	艗
艘	艘
艙	舱
艚	艚
艛	艛
艜	艜
艝	艝
艞	艞
艟	艟
艠	艠
艡	艡
艢	艢
艣	艣
艤	舣
艥	艥
艦	舰
艧	艧
艨	艨
艩	艩
艪	艪
艫	舻
艬	艬
艭	艭
艮	艮
良	良
艰	艰
艱	艰
色	色
艳	艳
艴	艴
艵	艵
艶	艶
艷	艳
艸	艸
艹	艹
艺	艺
艻	艻
艼	艼
艽	艽
艾	艾
艿	艿
芀	芀
芁	芁
节	节
芃	芃
芄	芄
芅	芅
芆	芆
芇	芇
芈	芈
芉	芉
芊	芊
芋	芋
芌	芌
芍	芍
芎	芎
芏	芏
芐	芐
芑	芑
芒	芒
芓	芓
芔	芔
芕	芕
芖	芖
芗	芗
芘	芘
芙	芙
芚	芚
芛	芛
芜	芜
芝	芝
芞	芞
芟	芟
芠	芠
芡	芡
芢	芢
芣	芣
芤	芤
芥	芥
芦	芦
芧	芧
芨	芨
芩	芩
芪	芪
芫	芫
芬	芬
芭	芭
芮	芮
芯	芯
芰	芰
花	花
芲	芲
芳	芳
芴	芴
芵	芵
芶	芶
芷	芷
芸	芸
芹	芹
芺	芺
芻	刍
芼	芼
芽	芽
芾	芾
芿	芿
苀	苀
苁	苁
苂	苂
苃	苃
苄	苄
苅	苅
苆	苆
苇	苇
苈	苈
苉	苉
苊	苊
苋	苋
苌	苌
苍	苍
苎	苎
苏	苏
苐	苐
苑	苑
苒	苒
苓	苓
苔	苔
苕	苕
苖	苖
苗	苗
苘	苘
苙	苙
苚	苚
苛	苛
苜	苜
苝	苝
苞	苞
苟	苟
苠	苠
苡	苡
苢	苢
苣	苣
苤	苤
若	若
苦	苦
苧	苎
苨	苨
苩	苩
苪	苪
苫	苫
苬	苬
苭	苭
苮	苮
苯	苯
苰	苰
英	英
苲	苲
苳	苳
苴	苴
苵	苵
苶	苶
苷	苷
苸	苸
苹	苹
苺	苺
苻	苻
苼	苼
苽	苽
苾	苾
苿	苿
茀	茀
茁	茁
茂	茂
范	范
茄	茄
茅	茅
茆	茆
茇	茇
茈	茈
茉	茉
茊	茊
茋	茋
茌	茌
茍	茍
茎	茎
茏	茏
茐	茐
茑	茑
茒	茒
茓	茓
茔	茔
茕	茕
茖	茖
茗	茗
茘	茘
茙	茙
茚	茚
茛	茛
茜	茜
茝	茝
茞	茞
茟	茟
茠	茠
茡	茡
茢	茢
茣	茣
茤	茤
茥	茥
茦	茦
茧	茧
茨	茨
茩	茩
茪	茪
茫	茫
茬	茬
茭	茭
茮	茮
茯	茯
茰	茰
茱	茱
茲	兹
茳	茳
茴	茴
茵	茵
茶	茶
茷	茷
茸	茸
茹	茹
茺	茺
茻	茻
茼	茼
茽	茽
茾	茾
茿	茿
荀	荀
荁	荁
荂	荂
荃	荃
荄	荄
荅	荅
荆	荆
荇	荇
荈	荈
草	草
荊	荆
荋	荋
荌	荌
荍	荍
荎	荎
荏	荏
荐	荐
荑	荑
荒	荒
荓	荓
荔	荔
荕	荕
荖	荖
荗	荗
荘	荘
荙	荙
荚	荚
荛	荛
荜	荜
荝	荝
荞	荞
荟	荟
荠	荠
荡	荡
荢	荢
荣	荣
荤	荤
荥	荥
荦	荦
荧	荧
荨	荨
荩	荩
荪	荪
荫	荫
荬	荬
荭	荭
荮	荮
药	药
荰	荰
荱	荱
荲	荲
荳	荳
荴	荴
荵	荵
荶	荶
荷	荷
荸	荸
荹	荹
荺	荺
荻	荻
荼	荼
荽	荽
荾	荾
荿	荿
莀	莀
莁	莁
莂	莂
莃	莃
莄	莄
莅	莅
莆	莆
莇	莇
莈	莈
莉	莉
莊	庄
莋	莋
莌	莌
莍	莍
莎	莎
莏	莏
莐	莐
莑	莑
莒	莒
莓	莓
莔	莔
莕	莕
莖	茎
莗	莗
莘	莘
莙	莙
莚	莚
莛	莛
莜	莜
莝	莝
莞	莞
莟	莟
莠	莠
莡	莡
莢	荚
莣	莣
莤	莤
莥	莥
莦	莦
莧	苋
莨	莨
莩	莩
莪	莪
莫	莫
莬	莬
莭	莭
莮	莮
莯	莯
莰	莰
莱	莱
莲	莲
莳	莳
莴	莴
莵	莵
莶	莶
获	获
莸	莸
莹	莹
莺	莺
莻	莻
莼	莼
莽	莽
莾	莾
莿	莿
菀	菀
菁	菁
菂	菂
菃	菃
菄	菄
菅	菅
菆	菆
菇	菇
菈	菈
菉	菉
菊	菊
菋	菋
菌	菌
菍	菍
菎	菎
菏	菏
菐	菐
菑	菑
菒	菒
菓	菓
菔	菔
菕	菕
菖	菖
菗	菗
菘	菘
菙	菙
菚	菚
菛	菛
菜	菜
菝	菝
菞	菞
菟	菟
菠	菠
菡	菡
菢	菢
菣	菣
菤	菤
菥	菥
菦	菦
菧	菧
菨	菨
菩	菩
菪	菪
菫	菫
菬	菬
菭	菭
菮	菮
華	华
菰	菰
菱	菱
菲	菲
菳	菳
菴	菴
菵	菵
菶	菶
菷	菷
菸	菸
菹	菹
菺	菺
菻	菻
菼	菼
菽	菽
菾	菾
菿	菿
萀	萀
萁	萁
萂	萂
萃	萃
萄	萄
萅	萅
萆	萆
萇	苌
萈	萈
萉	萉
萊	莱
萋	萋
萌	萌
萍	萍
萎	萎
萏	萏
萐	萐
萑	萑
萒	萒
萓	萓
萔	萔
萕	萕
萖	萖
萗	萗
萘	萘
萙	萙
萚	萚
萛	萛
萜	萜
萝	萝
萞	萞
萟	萟
萠	萠
萡	萡
萢	萢
萣	萣
萤	萤
营	营
萦	萦
萧	萧
萨	萨
萩	萩
萪	萪
萫	萫
萬	万
萭	萭
萮	萮
萯	萯
萰	萰
萱	萱
萲	萲
萳	萳
萴	荝
萵	莴
萶	萶
萷	萷
萸	萸
萹	萹
萺	萺
萻	萻
萼	萼
落	落
萾	萾
萿	萿
葀	葀
葁	葁
葂	葂
葃	葃
葄	葄
葅	葅
葆	葆
葇	葇
葈	葈
葉	叶
葊	葊
葋	葋
葌	葌
葍	葍
葎	葎
葏	葏
葐	葐
葑	葑
葒	荭
葓	葓
葔	葔
葕	葕
葖	葖
著	着
葘	葘
葙	葙
葚	葚
葛	葛
葜	葜
葝	葝
葞	葞
葟	葟
葠	葠
葡	葡
葢	葢
董	董
葤	荮
葥	葥
葦	苇
葧	葧
葨	葨
葩	葩
葪	葪
葫	葫
葬	葬
葭	葭
葮	葮
葯	葯
葰	葰
葱	葱
葲	葲
葳	葳
葴	葴
葵	葵
葶	葶
葷	荤
葸	葸
葹	葹
葺	葺
葻	葻
葼	葼
葽	葽
葾	葾
葿	葿
蒀	蒀
蒁	蒁
蒂	蒂
蒃	蒃
蒄	蒄
蒅	蒅
蒆	蒆
蒇	蒇
蒈	蒈
蒉	蒉
蒊	蒊
蒋	蒋
蒌	蒌
蒍	蒍
蒎	蒎
蒏	蒏
蒐	蒐
蒑	蒑
蒒	蒒
蒓	蒓
蒔	莳
蒕	蒕
蒖	蒖
蒗	蒗
蒘	蒘
蒙	蒙
蒚	蒚
蒛	蒛
蒜	蒜
蒝	蒝
蒞	莅
蒟	蒟
蒠	蒠
蒡	蒡
蒢	蒢
蒣	蒣
蒤	蒤
蒥	蒥
蒦	蒦
蒧	蒧
蒨	蒨
蒩	蒩
蒪	蒪
蒫	蒫
蒬	蒬
蒭	蒭
蒮	蒮
蒯	蒯
蒰	蒰
蒱	蒱
蒲	蒲
蒳	蒳
蒴	蒴
蒵	蒵
蒶	蒶
蒷	蒷
蒸	蒸
蒹	蒹
蒺	蒺
蒻	蒻
蒼	苍
蒽	蒽
蒾	蒾
蒿	蒿
蓀	荪
蓁	蓁
蓂	蓂
蓃	蓃
蓄	蓄
蓅	蓅
蓆	蓆
蓇	蓇
蓈	蓈
蓉	蓉
蓊	蓊
蓋	盖
蓌	蓌
蓍	蓍
蓎	蓎
蓏	蓏
蓐	蓐
蓑	蓑
蓒	蓒
蓓	蓓
蓔	蓔
蓕	蓕
蓖	蓖
蓗	蓗
蓘	蓘
蓙	蓙
蓚	蓚
蓛	蓛
蓜	蓜
蓝	蓝
蓞	蓞
蓟	蓟
蓠	蓠
蓡	蓡
蓢	蓢
蓣	蓣
蓤	蓤
蓥	蓥
蓦	蓦
蓧	蓧
蓨	蓨
蓩	蓩
蓪	蓪
蓫	蓫
蓬	蓬
蓭	蓭
蓮	莲
蓯	苁
蓰	蓰
蓱	蓱
蓲	蓲
蓳	蓳
蓴	莼
蓵	蓵
蓶	蓶
蓷	蓷
蓸	蓸
蓹	蓹
蓺	蓺
蓻	蓻
蓼	蓼
蓽	荜
蓾	蓾
蓿	蓿
蔀	蔀
蔁	蔁
蔂	蔂
蔃	蔃
蔄	蔄
蔅	蔅
蔆	蔆
蔇	蔇
蔈	蔈
蔉	蔉
蔊	蔊
蔋	蔋
蔌	蔌
蔍	蔍
蔎	蔎
蔏	蔏
蔐	蔐
蔑	蔑
蔒	蔒
蔓	蔓
蔔	蔔
蔕	蔕
蔖	蔖
蔗	蔗
蔘	蔘
蔙	蔙
蔚	蔚
蔛	蔛
蔜	蔜
蔝	蔝
蔞	蒌
蔟	蔟
蔠	蔠
蔡	蔡
蔢	蔢
蔣	蒋
蔤	蔤
蔥	葱
蔦	茑
蔧	蔧
蔨	蔨
蔩	蔩
蔪	蔪
蔫	蔫
蔬	蔬
蔭	荫
蔮	蔮
蔯	蔯
蔰	蔰
蔱	蔱
蔲	蔲
蔳	蔳
蔴	蔴
蔵	蔵
蔶	蔶
蔷	蔷
蔸	蔸
蔹	蔹
蔺	蔺
蔻	蔻
蔼	蔼
蔽	蔽
蔾	蔾
蔿	蔿
蕀	蕀
蕁	荨
蕂	蕂
蕃	蕃
蕄	蕄
蕅	蕅
蕆	蒇
蕇	蕇
蕈	蕈
蕉	蕉
蕊	蕊
蕋	蕋
蕌	蕌
蕍	蕍
蕎	荞
蕏	蕏
蕐	蕐
蕑	蕑
蕒	荬
蕓	芸
蕔	蕔
蕕	莸
蕖	蕖
蕗	蕗
蕘	荛
蕙	蕙
蕚	蕚
蕛	蕛
蕜	蕜
蕝	蕝
蕞	蕞
蕟	蕟
蕠	蕠
蕡	蕡
蕢	蒉
蕣	蕣
蕤	蕤
蕥	蕥
蕦	蕦
蕧	蕧
蕨	蕨
蕩	荡
蕪	芜
蕫	蕫
蕬	蕬
蕭	萧
蕮	蕮
蕯	蕯
蕰	蕰
蕱	蕱
蕲	蕲
蕳	蕳
蕴	蕴
蕵	蕵
蕶	蕶
蕷	蓣
蕸	蕸
蕹	蕹
蕺	蕺
蕻	蕻
蕼	蕼
蕽	蕽
蕾	蕾
蕿	蕿
薀	蕰
薁	薁
薂	薂
薃	薃
薄	薄
薅	薅
薆	薆
薇	薇
薈	荟
薉	薉
薊	蓟
薋	薋
薌	芗
薍	薍
薎	薎
薏	薏
薐	薐
薑	薑
薒	薒
薓	薓
薔	蔷
薕	薕
薖	薖
薗	薗
薘	荙
薙	薙
薚	薚
薛	薛
薜	薜
薝	薝
薞	薞
薟	莶
薠	薠
薡	薡
薢	薢
薣	薣
薤	薤
薥	薥
薦	荐
薧	薧
薨	薨
薩	萨
薪	薪
薫	薫
薬	薬
薭	薭
薮	薮
薯	薯
薰	薰
薱	薱
薲	薲
薳	薳
薴	苧
薵	薵
薶	薶
薷	薷
薸	薸
薹	薹
薺	荠
薻	薻
薼	薼
薽	薽
薾	薾
薿	薿
藀	藀
藁	藁
藂	藂
藃	藃
藄	藄
藅	藅
藆	藆
藇	藇
藈	藈
藉	藉
藊	藊
藋	藋
藌	藌
藍	蓝
藎	荩
藏	藏
藐	藐
藑	藑
藒	藒
藓	藓
藔	藔
藕	藕
藖	藖
藗	藗
藘	藘
藙	藙
藚	藚
藛	藛
藜	藜
藝	艺
藞	藞
藟	藟
藠	藠
藡	藡
藢	藢
藣	藣
藤	藤
藥	药
藦	藦
藧	藧
藨	藨
藩	藩
藪	薮
藫	藫
藬	藬
藭	藭
藮	藮
藯	藯
藰	藰
藱	藱
藲	藲
藳	藳
藴	藴
藵	藵
藶	苈
藷	藷
藸	藸
藹	蔼
藺	蔺
藻	藻
藼	藼
藽	藽
藾	藾
藿	藿
蘀	蘀
蘁	蘁
蘂	蘂
蘃	蘃
蘄	蕲
蘅	蘅
蘆	芦
蘇	苏
蘈	蘈
蘉	蘉
蘊	蕴
蘋	苹
蘌	蘌
蘍	蘍
蘎	蘎
蘏	蘏
蘐	蘐
蘑	蘑
蘒	蘒
蘓	蘓
蘔	蘔
蘕	蘕
蘖	蘖
蘗	蘗
蘘	蘘
蘙	蘙
蘚	藓
蘛	蘛
蘜	蘜
蘝	蘝
蘞	蔹
蘟	蘟
蘠	蘠
蘡	蘡
蘢	茏
蘣	蘣
蘤	蘤
蘥	蘥
蘦	蘦
蘧	蘧
蘨	蘨
蘩	蘩
蘪	蘪
蘫	蘫
蘬	蘬
蘭	兰
蘮	蘮
蘯	蘯
蘰	蘰
蘱	蘱
蘲	蘲
蘳	蘳
蘴	蘴
蘵	蘵
蘶	蘶
蘷	蘷
蘸	蘸
蘹	蘹
蘺	蓠
蘻	蘻
蘼	蘼
蘽	蘽
蘾	蘾
蘿	萝
虀	虀
虁	虁
虂	虂
虃	虃
虄	虄
虅	虅
虆	蔂
虇	虇
虈	虈
虉	虉
虊	虊
虋	虋
虌	虌
虍	虍
虎	虎
虏	虏
虐	虐
虑	虑
虒	虒
虓	虓
虔	虔
處	处
虖	虖
虗	虗
虘	虘
虙	虙
虚	虚
虛	虚
虜	虏
虝	虝
虞	虞
號	号
虠	虠
虡	虡
虢	虢
虣	虣
虤	虤
虥	虥
虦	虦
虧	亏
虨	虨
虩	虩
虪	虪
虫	虫
虬	虬
虭	虭
虮	虮
虯	虬
虰	虰
虱	虱
虲	虲
虳	虳
虴	虴
虵	虵
虶	虶
虷	虷
虸	虸
虹	虹
虺	虺
虻	虻
虼	虼
虽	虽
虾	虾
虿	虿
蚀	蚀
蚁	蚁
蚂	蚂
蚃	蚃
蚄	蚄
蚅	蚅
蚆	蚆
蚇	蚇
蚈	蚈
蚉	蚉
蚊	蚊
蚋	蚋
蚌	蚌
蚍	蚍
蚎	蚎
蚏	蚏
蚐	蚐
蚑	蚑
蚒	蚒
蚓	蚓
蚔	蚔
蚕	蚕
蚖	蚖
蚗	蚗
蚘	蚘
蚙	蚙
蚚	蚚
蚛	蚛
蚜	蚜
蚝	蚝
蚞	蚞
蚟	蚟
蚠	蚠
蚡	蚡
蚢	蚢
蚣	蚣
蚤	蚤
蚥	蚥
蚦	蚦
蚧	蚧
蚨	蚨
蚩	蚩
蚪	蚪
蚫	蚫
蚬	蚬
蚭	蚭
蚮	蚮
蚯	蚯
蚰	蚰
蚱	蚱
蚲	蚲
蚳	蚳
蚴	蚴
蚵	蚵
蚶	蚶
蚷	蚷
蚸	蚸
蚹	蚹
蚺	蚺
蚻	蚻
蚼	蚼
蚽	蚽
蚾	蚾
蚿	蚿
蛀	蛀
蛁	蛁
蛂	蛂
蛃	蛃
蛄	蛄
蛅	蛅
蛆	蛆
蛇	蛇
蛈	蛈
蛉	蛉
蛊	蛊
蛋	蛋
蛌	蛌
蛍	蛍
蛎	蛎
蛏	蛏
蛐	蛐
蛑	蛑
蛒	蛒
蛓	蛓
蛔	蛔
蛕	蛕
蛖	蛖
蛗	蛗
蛘	蛘
蛙	蛙
蛚	蛚
蛛	蛛
蛜	蛜
蛝	蛝
蛞	蛞
蛟	蛟
蛠	蛠
蛡	蛡
蛢	蛢
蛣	蛣
蛤	蛤
蛥	蛥
蛦	蛦
蛧	蛧
蛨	蛨
蛩	蛩
蛪	蛪
蛫	蛫
蛬	蛬
蛭	蛭
蛮	蛮
蛯	蛯
蛰	蛰
蛱	蛱
蛲	蛲
蛳	蛳
蛴	蛴
蛵	蛵
蛶	蛶
蛷	蛷
蛸	蛸
蛹	蛹
蛺	蛱
蛻	蜕
蛼	蛼
蛽	蛽
蛾	蛾
蛿	蛿
蜀	蜀
蜁	蜁
蜂	蜂
蜃	蜃
蜄	蜄
蜅	蜅
蜆	蚬
蜇	蜇
蜈	蜈
蜉	蜉
蜊	蜊
蜋	蜋
蜌	蜌
蜍	蜍
蜎	蜎
蜏	蜏
蜐	蜐
蜑	蜑
蜒	蜒
蜓	蜓
蜔	蜔
蜕	蜕
蜖	蜖
蜗	蜗
蜘	蜘
蜙	蜙
蜚	蜚
蜛	蜛
蜜	蜜
蜝	蜝
蜞	蜞
蜟	蜟
蜠	蜠
蜡	蜡
蜢	蜢
蜣	蜣
蜤	蜤
蜥	蜥
蜦	蜦
蜧	蜧
蜨	蜨
蜩	蜩
蜪	蜪
蜫	蜫
蜬	蜬
蜭	蜭
蜮	蜮
蜯	蜯
蜰	蜰
蜱	蜱
蜲	蜲
蜳	蜳
蜴	蜴
蜵	蜵
蜶	蜶
蜷	蜷
蜸	蜸
蜹	蜹
蜺	蜺
蜻	蜻
蜼	蜼
蜽	蜽
蜾	蜾
蜿	蜿
蝀	蝀
蝁	蝁
蝂	蝂
蝃	蝃
蝄	蝄
蝅	蝅
蝆	蝆
蝇	蝇
蝈	蝈
蝉	蝉
蝊	蝊
蝋	蝋
蝌	蝌
蝍	蝍
蝎	蝎
蝏	蝏
蝐	蝐
蝑	蝑
蝒	蝒
蝓	蝓
蝔	蝔
蝕	蚀
蝖	蝖
蝗	蝗
蝘	蝘
蝙	蝙
蝚	蝚
蝛	蝛
蝜	蝜
蝝	蝝
蝞	蝞
蝟	猬
蝠	蝠
蝡	蝡
蝢	蝢
蝣	蝣
蝤	蝤
蝥	蝥
蝦	虾
蝧	蝧
蝨	蝨
蝩	蝩
蝪	蝪
蝫	蝫
蝬	蝬
蝭	蝭
蝮	蝮
蝯	蝯
蝰	蝰
蝱	蝱
蝲	蝲
蝳	蝳
蝴	蝴
蝵	蝵
蝶	蝶
蝷	蝷
蝸	蜗
蝹	蝹
蝺	蝺
蝻	蝻
蝼	蝼
蝽	蝽
蝾	蝾
蝿	蝿
螀	螀
螁	螁
螂	螂
螃	螃
螄	蛳
螅	螅
螆	螆
螇	螇
螈	螈
螉	螉
螊	螊
螋	螋
螌	螌
融	融
螎	螎
螏	螏
螐	螐
螑	螑
螒	螒
螓	螓
螔	螔
螕	螕
螖	螖
螗	螗
螘	螘
螙	螙
螚	螚
螛	螛
螜	螜
螝	螝
螞	蚂
螟	螟
螠	螠
螡	螡
螢	萤
螣	螣
螤	螤
螥	螥
螦	螦
螧	螧
螨	螨
螩	螩
螪	螪
螫	螫
螬	螬
螭	螭
螮	螮
螯	螯
螰	螰
螱	螱
螲	螲
螳	螳
螴	螴
螵	螵
螶	螶
螷	螷
螸	螸
螹	螹
螺	螺
螻	蝼
螼	螼
螽	螽
螾	螾
螿	螀
蟀	蟀
蟁	蟁
蟂	蟂
蟃	蟃
蟄	蛰
蟅	蟅
蟆	蟆
蟇	蟇
蟈	蝈
蟉	蟉
蟊	蟊
蟋	蟋
蟌	蟌
蟍	蟍
蟎	螨
蟏	蟏
蟐	蟐
蟑	蟑
蟒	蟒
蟓	蟓
蟔	蟔
蟕	蟕
蟖	蟖
蟗	蟗
蟘	蟘
蟙	蟙
蟚	蟚
蟛	蟛
蟜	蟜
蟝	蟝
蟞	蟞
蟟	蟟
蟠	蟠
蟡	蟡
蟢	蟢
蟣	虮
蟤	蟤
蟥	蟥
蟦	蟦
蟧	蟧
蟨	蟨
蟩	蟩
蟪	蟪
蟫	蟫
蟬	蝉
蟭	蟭
蟮	蟮
蟯	蛲
蟰	蟰
蟱	蟱
蟲	虫
蟳	蟳
蟴	蟴
蟵	蟵
蟶	蛏
蟷	蟷
蟸	蟸
蟹	蟹
蟺	蟺
蟻	蚁
蟼	蟼
蟽	蟽
蟾	蟾
蟿	蟿
蠀	蠀
蠁	蚃
蠂	蠂
蠃	蠃
蠄	蠄
蠅	蝇
蠆	虿
蠇	蠇
蠈	蠈
蠉	蠉
蠊	蠊
蠋	蠋
蠌	蠌
蠍	蠍
蠎	蠎
蠏	蠏
蠐	蛴
蠑	蝾
蠒	蠒
蠓	蠓
蠔	蠔
蠕	蠕
蠖	蠖
蠗	蠗
蠘	蠘
蠙	蠙
蠚	蠚
蠛	蠛
蠜	蠜
蠝	蠝
蠞	蠞
蠟	蜡
蠠	蠠
蠡	蠡
蠢	蠢
蠣	蛎
蠤	蠤
蠥	蠥
蠦	蠦
蠧	蠧
蠨	蟏
蠩	蠩
蠪	蠪
蠫	蠫
蠬	蠬
蠭	蠭
蠮	蠮
蠯	蠯
蠰	蠰
蠱	蛊
蠲	蠲
蠳	蠳
蠴	蠴
蠵	蠵
蠶	蚕
蠷	蠷
蠸	蠸
蠹	蠹
蠺	蠺
蠻	蛮
蠼	蠼
蠽	蠽
蠾	蠾
蠿	蠿
血	血
衁	衁
衂	衂
衃	衃
衄	衄
衅	衅
衆	衆
衇	衇
衈	衈
衉	衉
衊	衊
衋	衋
行	行
衍	衍
衎	衎
衏	衏
衐	衐
衑	衑
衒	衒
術	术
衔	衔
衕	同
衖	衖
街	街
衘	衘
衙	衙
衚	胡
衛	卫
衜	衜
衝	冲
衞	衞
衟	衟
衠	衠
衡	衡
衢	衢
衣	衣
衤	衤
补	补
衦	衦
衧	衧
表	表
衩	衩
衪	衪
衫	衫
衬	衬
衭	衭
衮	衮
衯	衯
衰	衰
衱	衱
衲	衲
衳	衳
衴	衴
衵	衵
衶	衶
衷	衷
衸	衸
衹	衹
衺	衺
衻	衻
衼	衼
衽	衽
衾	衾
衿	衿
袀	袀
袁	袁
袂	袂
袃	袃
袄	袄
袅	袅
袆	袆
袇	袇
袈	袈
袉	袉
袊	袊
袋	袋
袌	袌
袍	袍
袎	袎
袏	袏
袐	袐
袑	袑
袒	袒
袓	袓
袔	袔
袕	袕
袖	袖
袗	袗
袘	袘
袙	袙
袚	袚
袛	袛
袜	袜
袝	袝
袞	衮
袟	袟
袠	袠
袡	袡
袢	袢
袣	袣
袤	袤
袥	袥
袦	袦
袧	袧
袨	袨
袩	袩
袪	袪
被	被
袬	袬
袭	袭
袮	袮
袯	袯
袰	袰
袱	袱
袲	袲
袳	袳
袴	袴
袵	袵
袶	袶
袷	袷
袸	袸
袹	袹
袺	袺
袻	袻
袼	袼
袽	袽
袾	袾
袿	袿
裀	裀
裁	裁
裂	裂
裃	裃
裄	裄
装	装
裆	裆
裇	裇
裈	裈
裉	裉
裊	袅
裋	裋
裌	裌
裍	裍
裎	裎
裏	裏
裐	裐
裑	裑
裒	裒
裓	裓
裔	裔
裕	裕
裖	裖
裗	裗
裘	裘
裙	裙
裚	裚
裛	裛
補	补
裝	装
裞	裞
裟	裟
裠	裠
裡	里
裢	裢
裣	裣
裤	裤
裥	裥
裦	裦
裧	裧
裨	裨
裩	裩
裪	裪
裫	裫
裬	裬
裭	裭
裮	裮
裯	裯
裰	裰
裱	裱
裲	裲
裳	裳
裴	裴
裵	裵
裶	裶
裷	裷
裸	裸
裹	裹
裺	裺
裻	裻
裼	裼
製	制
裾	裾
裿	裿
褀	褀
褁	褁
褂	褂
褃	褃
褄	褄
褅	褅
褆	褆
複	复
褈	褈
褉	褉
褊	褊
褋	褋
褌	裈
褍	褍
褎	褎
褏	褏
褐	褐
褑	褑
褒	褒
褓	褓
褔	褔
褕	褕
褖	褖
褗	褗
褘	袆
褙	褙
褚	褚
褛	褛
褜	褜
褝	褝
褞	褞
褟	褟
褠	褠
褡	褡
褢	褢
褣	褣
褤	褤
褥	褥
褦	褦
褧	褧
褨	褨
褩	褩
褪	褪
褫	褫
褬	褬
褭	褭
褮	褮
褯	褯
褰	褰
褱	褱
褲	裤
褳	裢
褴	褴
褵	褵
褶	褶
褷	褷
褸	褛
褹	褹
褺	褺
褻	亵
褼	褼
褽	褽
褾	褾
褿	褿
襀	襀
襁	襁
襂	襂
襃	襃
襄	襄
襅	襅
襆	襆
襇	襇
襈	襈
襉	裥
襊	襊
襋	襋
襌	襌
襍	襍
襎	襎
襏	袯
襐	襐
襑	襑
襒	襒
襓	襓
襔	襔
襕	襕
襖	袄
襗	襗
襘	襘
襙	襙
襚	襚
襛	襛
襜	襜
襝	裣
襞	襞
襟	襟
襠	裆
襡	襡
襢	襢
襣	襣
襤	褴
襥	襥
襦	襦
襧	襧
襨	襨
襩	襩
襪	袜
襫	襫
襬	襬
襭	襭
襮	襮
襯	衬
襰	襰
襱	襱
襲	袭
襳	襳
襴	襕
襵	襵
襶	襶
襷	襷
襸	襸
襹	襹
襺	襺
襻	襻
襼	襼
襽	襽
襾	襾
西	西
覀	覀
要	要
覂	覂
覃	覃
覄	覄
覅	覅
覆	复
覇	覇
覈	覈
覉	覉
覊	覊
見	见
覌	覌
覍	覍
覎	觃
規	规
覐	覐
覑	覑
覒	覒
覓	觅
覔	覔
覕	覕
視	视
覗	覗
覘	觇
覙	覙
覚	覚
覛	覛
覜	覜
覝	覝
覞	覞
覟	覟
覠	覠
覡	觋
覢	覢
覣	覣
覤	覤
覥	觍
覦	觎
覧	覧
覨	覨
覩	覩
親	亲
覫	覫
覬	觊
覭	覭
覮	覮
覯	觏
覰	覰
覱	覱
覲	觐
観	観
覴	覴
覵	覵
覶	覶
覷	觑
覸	覸
覹	覹
覺	觉
覻	覻
覼	覼
覽	览
覾	覾
覿	觌
觀	观
见	见
观	观
觃	觃
规	规
觅	觅
视	视
觇	觇
览	览
觉	觉
觊	觊
觋	觋
觌	觌
觍	觍
觎	觎
觏	觏
觐	觐
觑	觑
角	角
觓	觓
觔	觔
觕	觕
觖	觖
觗	觗
觘	觘
觙	觙
觚	觚
觛	觛
觜	觜
觝	觝
觞	觞
觟	觟
觠	觠
觡	觡
觢	觢
解	解
觤	觤
觥	觥
触	触
觧	觧
觨	觨
觩	觩
觪	觪
觫	觫
觬	觬
觭	觭
觮	觮
觯	觯
觰	觰
觱	觱
觲	觲
觳	觳
觴	觞
觵	觵
觶	觯
觷	觷
觸	触
觹	觹
觺	觺
觻	觻
觼	觼
觽	觽
觾	觾
觿	觿
言	言
訁	讠
訂	订
訃	讣
訄	訄
訅	訅
訆	訆
訇	訇
計	计
訉	訉
訊	讯
訋	訋
訌	讧
訍	訍
討	讨
訏	訏
訐	讦
訑	訑
訒	讱
訓	训
訔	訔
訕	讪
訖	讫
託	讬
記	记
訙	訙
訚	訚
訛	讹
訜	訜
訝	讶
訞	訞
訟	讼
訠	訠
訡	訡
訢	訢
訣	诀
訤	訤
訥	讷
訦	訦
訧	訧
訨	訨
訩	讻
訪	访
訫	訫
訬	訬
設	设
訮	訮
訯	訯
訰	訰
許	许
訲	訲
訳	訳
訴	诉
訵	訵
訶	诃
訷	訷
訸	訸
訹	訹
診	诊
註	注
証	証
訽	訽
訾	訾
訿	訿
詀	詀
詁	诂
詂	詂
詃	詃
詄	詄
詅	詅
詆	诋
詇	詇
詈	詈
詉	詉
詊	詊
詋	詋
詌	詌
詍	詍
詎	讵
詏	詏
詐	诈
詑	詑
詒	诒
詓	詓
詔	诏
評	评
詖	诐
詗	诇
詘	诎
詙	詙
詚	詚
詛	诅
詜	詜
詝	詝
詞	词
詟	詟
詠	咏
詡	诩
詢	询
詣	诣
詤	詤
詥	詥
試	试
詧	詧
詨	詨
詩	诗
詪	詪
詫	诧
詬	诟
詭	诡
詮	诠
詯	詯
詰	诘
話	话
該	该
詳	详
詴	詴
詵	诜
詶	詶
詷	詷
詸	詸
詹	詹
詺	詺
詻	詻
詼	诙
詽	詽
詾	詾
詿	诖
誀	誀
誁	誁
誂	誂
誃	誃
誄	诔
誅	诛
誆	诓
誇	夸
誈	誈
誉	誉
誊	誊
誋	誋
誌	志
認	认
誎	誎
誏	誏
誐	誐
誑	诳
誒	诶
誓	誓
誔	誔
誕	诞
誖	誖
誗	誗
誘	诱
誙	誙
誚	诮
誛	誛
誜	誜
誝	誝
語	语
誟	誟
誠	诚
誡	诫
誢	誢
誣	诬
誤	误
誥	诰
誦	诵
誧	誧
誨	诲
誩	誩
說	说
誫	誫
説	説
読	読
誮	誮
誯	誯
誰	谁
誱	誱
課	课
誳	誳
誴	誴
誵	誵
誶	谇
誷	誷
誸	誸
誹	诽
誺	誺
誻	誻
誼	谊
誽	誽
誾	訚
調	调
諀	諀
諁	諁
諂	谄
諃	諃
諄	谆
諅	諅
諆	諆
談	谈
諈	諈
諉	诿
諊	諊
請	请
諌	諌
諍	诤
諎	諎
諏	诹
諐	諐
諑	诼
諒	谅
諓	諓
諔	諔
諕	諕
論	论
諗	谂
諘	諘
諙	諙
諚	諚
諛	谀
諜	谍
諝	谞
諞	谝
諟	諟
諠	諠
諡	諡
諢	诨
諣	諣
諤	谔
諥	諥
諦	谛
諧	谐
諨	諨
諩	諩
諪	諪
諫	谏
諬	諬
諭	谕
諮	谘
諯	諯
諰	諰
諱	讳
諲	諲
諳	谙
諴	諴
諵	諵
諶	谌
諷	讽
諸	诸
諹	諹
諺	谚
諻	諻
諼	谖
諽	諽
諾	诺
諿	諿
謀	谋
謁	谒
謂	谓
謃	謃
謄	誊
謅	诌
謆	謆
謇	謇
謈	謈
謉	謉
謊	谎
謋	謋
謌	謌
謍	謍
謎	谜
謏	謏
謐	谧
謑	謑
謒	謒
謓	謓
謔	谑
謕	謕
謖	谡
謗	谤
謘	謘
謙	谦
謚	谥
講	讲
謜	謜
謝	谢
謞	謞
謟	謟
謠	谣
謡	謡
謢	謢
謣	謣
謤	謤
謥	謥
謦	謦
謧	謧
謨	谟
謩	謩
謪	謪
謫	谪
謬	谬
謭	謭
謮	謮
謯	謯
謰	謰
謱	謱
謲	謲
謳	讴
謴	謴
謵	謵
謶	謶
謷	謷
謸	謸
謹	谨
謺	謺
謻	謻
謼	謼
謽	謽
謾	谩
謿	謿
譀	譀
譁	譁
譂	譂
譃	譃
譄	譄
譅	譅
譆	譆
譇	譇
譈	譈
證	证
譊	譊
譋	譋
譌	譌
譍	譍
譎	谲
譏	讥
譐	譐
譑	譑
譒	譒
譓	譓
譔	譔
譕	譕
譖	谮
譗	譗
識	识
譙	谯
譚	谭
譛	譛
譜	谱
譝	譝
譞	譞
譟	譟
譠	譠
譡	譡
譢	譢
譣	譣
譤	譤
譥	譥
警	警
譧	譧
譨	譨
譩	譩
譪	譪
譫	谵
譬	譬
譭	譭
譮	譮
譯	译
議	议
譱	譱
譲	譲
譳	譳
譴	谴
譵	譵
譶	譶
護	护
譸	诪
譹	譹
譺	譺
譻	譻
譼	譼
譽	誉
譾	谫
譿	譿
讀	读
讁	讁
讂	讂
讃	讃
讄	讄
讅	讅
讆	讆
讇	讇
讈	讈
讉	讉
變	变
讋	詟
讌	讌
讍	讍
讎	雠
讏	讏
讐	讐
讑	讑
讒	谗
讓	让
讔	讔
讕	谰
讖	谶
讗	讗
讘	讘
讙	讙
讚	讚
讛	讛
讜	谠
讝	讝
讞	谳
讟	讟
讠	讠
计	计
订	订
讣	讣
认	认
讥	讥
讦	讦
讧	讧
讨	讨
让	让
讪	讪
讫	讫
讬	讬
训	训
议	议
讯	讯
记	记
讱	讱
讲	讲
讳	讳
讴	讴
讵	讵
讶	讶
讷	讷
许	许
讹	讹
论	论
讻	讻
讼	讼
讽	讽
设	设
访	访
诀	诀
证	证
诂	诂
诃	诃
评	评
诅	诅
识	识
诇	诇
诈	诈
诉	诉
诊	诊
诋	诋
诌	诌
词	词
诎	诎
诏	诏
诐	诐
译	译
诒	诒
诓	诓
诔	诔
试	试
诖	诖
诗	诗
诘	诘
诙	诙
诚	诚
诛	诛
诜	诜
话	话
诞	诞
诟	诟
诠	诠
诡	诡
询	询
诣	诣
诤	诤
该	该
详	详
诧	诧
诨	诨
诩	诩
诪	诪
诫	诫
诬	诬
语	语
诮	诮
误	误
诰	诰
诱	诱
诲	诲
诳	诳
说	说
诵	诵
诶	诶
请	请
诸	诸
诹	诹
诺	诺
读	读
诼	诼
诽	诽
课	课
诿	诿
谀	谀
谁	谁
谂	谂
调	调
谄	谄
谅	谅
谆	谆
谇	谇
谈	谈
谉	谉
谊	谊
谋	谋
谌	谌
谍	谍
谎	谎
谏	谏
谐	谐
谑	谑
谒	谒
谓	谓
谔	谔
谕	谕
谖	谖
谗	谗
谘	谘
谙	谙
谚	谚
谛	谛
谜	谜
谝	谝
谞	谞
谟	谟
谠	谠
谡	谡
谢	谢
谣	谣
谤	谤
谥	谥
谦	谦
谧	谧
谨	谨
谩	谩
谪	谪
谫	谫
谬	谬
谭	谭
谮	谮
谯	谯
谰	谰
谱	谱
谲	谲
谳	谳
谴	谴
谵	谵
谶	谶
谷	谷
谸	谸
谹	谹
谺	谺
谻	谻
谼	谼
谽	谽
谾	谾
谿	谿
豀	豀
豁	豁
豂	豂
豃	豃
豄	豄
豅	豅
豆	豆
豇	豇
豈	岂
豉	豉
豊	豊
豋	豋
豌	豌
豍	豍
豎	竖
豏	豏
豐	丰
豑	豑
豒	豒
豓	豓
豔	豔
豕	豕
豖	豖
豗	豗
豘	豘
豙	豙
豚	豚
豛	豛
豜	豜
豝	豝
豞	豞
豟	豟
豠	豠
象	象
豢	豢
豣	豣
豤	豤
豥	豥
豦	豦
豧	豧
豨	豨
豩	豩
豪	豪
豫	豫
豬	猪
豭	豭
豮	豮
豯	豯
豰	豰
豱	豱
豲	豲
豳	豳
豴	豴
豵	豵
豶	豮
豷	豷
豸	豸
豹	豹
豺	豺
豻	豻
豼	豼
豽	豽
豾	豾
豿	豿
貀	貀
貁	貁
貂	貂
貃	貃
貄	貄
貅	貅
貆	貆
貇	貇
貈	貈
貉	貉
貊	貊
貋	貋
貌	貌
貍	貍
貎	貎
貏	貏
貐	貐
貑	貑
貒	貒
貓	猫
貔	貔
貕	貕
貖	貖
貗	貗
貘	貘
貙	貙
貚	貚
貛	貛
貜	貜
貝	贝
貞	贞
貟	贠
負	负
財	财
貢	贡
貣	貣
貤	貤
貥	貥
貦	貦
貧	贫
貨	货
販	贩
貪	贪
貫	贯
責	责
貭	貭
貮	貮
貯	贮
貰	贳
貱	貱
貲	赀
貳	贰
貴	贵
貵	貵
貶	贬
買	买
貸	贷
貹	貹
貺	贶
費	费
貼	贴
貽	贻
貾	貾
貿	贸
賀	贺
賁	贲
賂	赂
賃	赁
賄	贿
賅	赅
賆	賆
資	资
賈	贾
賉	賉
賊	贼
賋	賋
賌	賌
賍	賍
賎	賎
賏	賏
賐	賐
賑	赈
賒	赊
賓	宾
賔	賔
賕	赇
賖	賖
賗	賗
賘	賘
賙	赒
賚	赉
賛	賛
賜	赐
賝	賝
賞	赏
賟	賟
賠	赔
賡	赓
賢	贤
賣	卖
賤	贱
賥	賥
賦	赋
賧	赕
賨	賨
賩	賩
質	质
賫	賫
賬	账
賭	赌
賮	賮
賯	賯
賰	賰
賱	賱
賲	賲
賳	賳
賴	赖
賵	赗
賶	賶
賷	賷
賸	賸
賹	賹
賺	赚
賻	赙
購	购
賽	赛
賾	赜
賿	賿
贀	贀
贁	贁
贂	贂
贃	贃
贄	贽
贅	赘
贆	贆
贇	赟
贈	赠
贉	贉
贊	赞
贋	贋
贌	贌
贍	赡
贎	贎
贏	赢
贐	赆
贑	贑
贒	贒
贓	赃
贔	赑
贕	贕
贖	赎
贗	赝
贘	贘
贙	贙
贚	贚
贛	赣
贜	贜
贝	贝
贞	贞
负	负
贠	贠
贡	贡
财	财
责	责
贤	贤
败	败
账	账
货	货
质	质
贩	贩
贪	贪
贫	贫
贬	贬
购	购
贮	贮
贯	贯
贰	贰
贱	贱
贲	贲
贳	贳
贴	贴
贵	贵
贶	贶
贷	贷
贸	贸
费	费
贺	贺
贻	贻
贼	贼
贽	贽
贾	贾
贿	贿
赀	赀
赁	赁
赂	赂
赃	赃
资	资
赅	赅
赆	赆
赇	赇
赈	赈
赉	赉
赊	赊
赋	赋
赌	赌
赍	赍
赎	赎
赏	赏
赐	赐
赑	赑
赒	赒
赓	赓
赔	赔
赕	赕
赖	赖
赗	赗
赘	赘
赙	赙
赚	赚
赛	赛
赜	赜
赝	赝
赞	赞
赟	赟
赠	赠
赡	赡
赢	赢
赣	赣
赤	赤
赥	赥
赦	赦
赧	赧
赨	赨
赩	赩
赪	赪
赫	赫
赬	赪
赭	赭
赮	赮
赯	赯
走	走
赱	赱
赲	赲
赳	赳
赴	赴
赵	赵
赶	赶
起	起
赸	赸
赹	赹
赺	赺
赻	赻
赼	赼
赽	赽
赾	赾
赿	赿
趀	趀
趁	趁
趂	趂
趃	趃
趄	趄
超	超
趆	趆
趇	趇
趈	趈
趉	趉
越	越
趋	趋
趌	趌
趍	趍
趎	趎
趏	趏
趐	趐
趑	趑
趒	趒
趓	趓
趔	趔
趕	赶
趖	趖
趗	趗
趘	趘
趙	赵
趚	趚
趛	趛
趜	趜
趝	趝
趞	趞
趟	趟
趠	趠
趡	趡
趢	趢
趣	趣
趤	趤
趥	趥
趦	趦
趧	趧
趨	趋
趩	趩
趪	趪
趫	趫
趬	趬
趭	趭
趮	趮
趯	趯
趰	趰
趱	趱
趲	趱
足	足
趴	趴
趵	趵
趶	趶
趷	趷
趸	趸
趹	趹
趺	趺
趻	趻
趼	趼
趽	趽
趾	趾
趿	趿
跀	跀
跁	跁
跂	跂
跃	跃
跄	跄
跅	跅
跆	跆
跇	跇
跈	跈
跉	跉
跊	跊
跋	跋
跌	跌
跍	跍
跎	跎
跏	跏
跐	跐
跑	跑
跒	跒
跓	跓
跔	跔
跕	跕
跖	跖
跗	跗
跘	跘
跙	跙
跚	跚
跛	跛
跜	跜
距	距
跞	跞
跟	跟
跠	跠
跡	迹
跢	跢
跣	跣
跤	跤
跥	跥
跦	跦
跧	跧
跨	跨
跩	跩
跪	跪
跫	跫
跬	跬
跭	跭
跮	跮
路	路
跰	跰
跱	跱
跲	跲
跳	跳
跴	跴
践	践
跶	跶
跷	跷
跸	跸
跹	跹
跺	跺
跻	跻
跼	跼
跽	跽
跾	跾
跿	跿
踀	踀
踁	踁
踂	踂
踃	踃
踄	踄
踅	踅
踆	踆
踇	踇
踈	踈
踉	踉
踊	踊
踋	踋
踌	踌
踍	踍
踎	踎
踏	踏
踐	践
踑	踑
踒	踒
踓	踓
踔	踔
踕	踕
踖	踖
踗	踗
踘	踘
踙	踙
踚	踚
踛	踛
踜	踜
踝	踝
踞	踞
踟	踟
踠	踠
踡	踡
踢	踢
踣	踣
踤	踤
踥	踥
踦	踦
踧	踧
踨	踨
踩	踩
踪	踪
踫	踫
踬	踬
踭	踭
踮	踮
踯	踯
踰	踰
踱	踱
踲	踲
踳	踳
踴	踊
踵	踵
踶	踶
踷	踷
踸	踸
踹	踹
踺	踺
踻	踻
踼	踼
踽	踽
踾	踾
踿	踿
蹀	蹀
蹁	蹁
蹂	蹂
蹃	蹃
蹄	蹄
蹅	蹅
蹆	蹆
蹇	蹇
蹈	蹈
蹉	蹉
蹊	蹊
蹋	蹋
蹌	跄
蹍	蹍
蹎	蹎
蹏	蹏
蹐	蹐
蹑	蹑
蹒	蹒
蹓	蹓
蹔	蹔
蹕	跸
蹖	蹖
蹗	蹗
蹘	蹘
蹙	蹙
蹚	蹚
蹛	蹛
蹜	蹜
蹝	蹝
蹞	蹞
蹟	蹟
蹠	蹠
蹡	蹡
蹢	蹢
蹣	蹒
蹤	踪
蹥	蹥
蹦	蹦
蹧	蹧
蹨	蹨
蹩	蹩
蹪	蹪
蹫	蹫
蹬	蹬
蹭	蹭
蹮	蹮
蹯	蹯
蹰	蹰
蹱	蹱
蹲	蹲
蹳	蹳
蹴	蹴
蹵	蹵
蹶	蹶
蹷	蹷
蹸	蹸
蹹	蹹
蹺	跷
蹻	蹻
蹼	蹼
蹽	蹽
蹾	蹾
蹿	蹿
躀	躀
躁	躁
躂	跶
躃	躃
躄	躄
躅	躅
躆	躆
躇	躇
躈	躈
躉	趸
躊	踌
躋	跻
躌	躌
躍	跃
躎	躎
躏	躏
躐	躐
躑	踯
躒	跞
躓	踬
躔	躔
躕	蹰
躖	躖
躗	躗
躘	躘
躙	躙
躚	跹
躛	躛
躜	躜
躝	躝
躞	躞
躟	躟
躠	躠
躡	蹑
躢	躢
躣	躣
躤	躤
躥	蹿
躦	躜
躧	躧
躨	躨
躩	躩
躪	躏
身	身
躬	躬
躭	躭
躮	躮
躯	躯
躰	躰
躱	躱
躲	躲
躳	躳
躴	躴
躵	躵
躶	躶
躷	躷
躸	躸
躹	躹
躺	躺
躻	躻
躼	躼
躽	躽
躾	躾
躿	躿
軀	躯
軁	軁
軂	軂
軃	軃
軄	軄
軅	軅
軆	軆
軇	軇
軈	軈
軉	軉
車	车
軋	轧
軌	轨
軍	军
軎	軎
軏	軏
軐	軐
軑	轪
軒	轩
軓	軓
軔	轫
軕	軕
軖	軖
軗	軗
軘	軘
軙	軙
軚	軚
軛	轭
軜	軜
軝	軝
軞	軞
軟	软
軠	軠
軡	軡
転	転
軣	軣
軤	轷
軥	軥
軦	軦
軧	軧
軨	軨
軩	軩
軪	軪
軫	轸
軬	軬
軭	軭
軮	軮
軯	軯
軰	軰
軱	軱
軲	轱
軳	軳
軴	軴
軵	軵
軶	軶
軷	軷
軸	轴
軹	轵
軺	轺
軻	轲
軼	轶
軽	軽
軾	轼
軿	軿
輀	輀
輁	輁
輂	輂
較	较
輄	輄
輅	辂
輆	輆
輇	辁
輈	辀
載	载
輊	轾
輋	輋
輌	輌
輍	輍
輎	輎
輏	輏
輐	輐
輑	輑
輒	辄
輓	挽
輔	辅
輕	轻
輖	輖
輗	輗
輘	輘
輙	輙
輚	輚
輛	辆
輜	辎
輝	辉
輞	辋
輟	辍
輠	輠
輡	輡
輢	輢
輣	輣
輤	輤
輥	辊
輦	辇
輧	輧
輨	輨
輩	辈
輪	轮
輫	輫
輬	辌
輭	輭
輮	輮
輯	辑
輰	輰
輱	輱
輲	輲
輳	辏
輴	輴
輵	輵
輶	輶
輷	輷
輸	输
輹	輹
輺	輺
輻	辐
輼	輼
輽	輽
輾	辗
輿	舆
轀	辒
轁	轁
轂	毂
轃	轃
轄	辖
轅	辕
轆	辘
轇	轇
轈	轈
轉	转
轊	轊
轋	轋
轌	轌
轍	辙
轎	轿
轏	轏
轐	轐
轑	轑
轒	轒
轓	轓
轔	辚
轕	轕
轖	轖
轗	轗
轘	轘
轙	轙
轚	轚
轛	轛
轜	轜
轝	轝
轞	轞
轟	轰
轠	轠
轡	辔
轢	轹
轣	轣
轤	轳
轥	轥
车	车
轧	轧
轨	轨
轩	轩
轪	轪
轫	轫
转	转
轭	轭
轮	轮
软	软
轰	轰
轱	轱
轲	轲
轳	轳
轴	轴
轵	轵
轶	轶
轷	轷
轸	轸
轹	轹
轺	轺
轻	轻
轼	轼
载	载
轾	轾
轿	轿
辀	辀
辁	辁
辂	辂
较	较
辄	辄
辅	辅
辆	辆
辇	辇
辈	辈
辉	辉
辊	辊
辋	辋
辌	辌
辍	辍
辎	辎
辏	辏
辐	辐
辑	辑
辒	辒
输	输
辔	辔
辕	辕
辖	辖
辗	辗
辘	辘
辙	辙
辚	辚
辛	辛
辜	辜
辝	辝
辞	辞
辟	辟
辠	辠
辡	辡
辢	辢
辣	辣
辤	辤
辥	辥
辦	办
辧	辧
辨	辨
辩	辩
辪	辪
辫	辫
辬	辬
辭	辞
辮	辫
辯	辩
辰	辰
辱	辱
農	农
辳	辳
辴	辴
辵	辵
辶	辶
辷	辷
辸	辸
边	边
辺	辺
辻	辻
込	込
辽	辽
达	达
辿	辿
迀	迀
迁	迁
迂	迂
迃	迃
迄	迄
迅	迅
迆	迆
过	过
迈	迈
迉	迉
迊	迊
迋	迋
迌	迌
迍	迍
迎	迎
迏	迏
运	运
近	近
迒	迒
迓	迓
返	返
迕	迕
迖	迖
迗	迗
还	还
这	这
迚	迚
进	进
远	远
违	违
连	连
迟	迟
迠	迠
迡	迡
迢	迢
迣	迣
迤	迤
迥	迥
迦	迦
迧	迧
迨	迨
迩	迩
迪	迪
迫	迫
迬	迬
迭	迭
迮	迮
迯	迯
述	述
迱	迱
迲	迲
迳	迳
迴	迴
迵	迵
迶	迶
迷	迷
迸	迸
迹	迹
迺	迺
迻	迻
迼	迼
追	追
迾	迾
迿	迿
退	退
送	送
适	适
逃	逃
逄	逄
逅	逅
逆	逆
逇	逇
逈	逈
选	选
逊	逊
逋	逋
逌	逌
逍	逍
逎	逎
透	透
逐	逐
逑	逑
递	递
逓	逓
途	途
逕	迳
逖	逖
逗	逗
逘	逘
這	这
通	通
逛	逛
逜	逜
逝	逝
逞	逞
速	速
造	造
逡	逡
逢	逢
連	连
逤	逤
逥	逥
逦	逦
逧	逧
逨	逨
逩	逩
逪	逪
逫	逫
逬	逬
逭	逭
逮	逮
逯	逯
逰	逰
週	週
進	进
逳	逳
逴	逴
逵	逵
逶	逶
逷	逷
逸	逸
逹	逹
逺	逺
逻	逻
逼	逼
逽	逽
逾	逾
逿	逿
遀	遀
遁	遁
遂	遂
遃	遃
遄	遄
遅	遅
遆	遆
遇	遇
遈	遈
遉	遉
遊	遊
運	运
遌	遌
遍	遍
過	过
遏	遏
遐	遐
遑	遑
遒	遒
道	道
達	达
違	违
遖	遖
遗	遗
遘	遘
遙	遥
遚	遚
遛	遛
遜	逊
遝	遝
遞	递
遟	遟
遠	远
遡	遡
遢	遢
遣	遣
遤	遤
遥	遥
遦	遦
遧	遧
遨	遨
適	适
遪	遪
遫	遫
遬	遬
遭	遭
遮	遮
遯	遯
遰	遰
遱	遱
遲	迟
遳	遳
遴	遴
遵	遵
遶	遶
遷	迁
選	选
遹	遹
遺	遗
遻	遻
遼	辽
遽	遽
遾	遾
避	避
邀	邀
邁	迈
邂	邂
邃	邃
還	还
邅	邅
邆	邆
邇	迩
邈	邈
邉	邉
邊	边
邋	邋
邌	邌
邍	邍
邎	邎
邏	逻
邐	逦
邑	邑
邒	邒
邓	邓
邔	邔
邕	邕
邖	邖
邗	邗
邘	邘
邙	邙
邚	邚
邛	邛
邜	邜
邝	邝
邞	邞
邟	邟
邠	邠
邡	邡
邢	邢
那	那
邤	邤
邥	邥
邦	邦
邧	邧
邨	邨
邩	邩
邪	邪
邫	邫
邬	邬
邭	邭
邮	邮
邯	邯
邰	邰
邱	邱
邲	邲
邳	邳
邴	邴
邵	邵
邶	邶
邷	邷
邸	邸
邹	邹
邺	邺
邻	邻
邼	邼
邽	邽
邾	邾
邿	邿
郀	郀
郁	郁
郂	郂
郃	郃
郄	郄
郅	郅
郆	郆
郇	郇
郈	郈
郉	郉
郊	郊
郋	郋
郌	郌
郍	郍
郎	郎
郏	郏
郐	郐
郑	郑
郒	郒
郓	郓
郔	郔
郕	郕
郖	郖
郗	郗
郘	郘
郙	郙
郚	郚
郛	郛
郜	郜
郝	郝
郞	郞
郟	郏
郠	郠
郡	郡
郢	郢
郣	郣
郤	郤
郥	郥
郦	郦
郧	郧
部	部
郩	郩
郪	郪
郫	郫
郬	郬
郭	郭
郮	郮
郯	郯
郰	郰
郱	郱
郲	郲
郳	郳
郴	郴
郵	邮
郶	郶
郷	郷
郸	郸
郹	郹
郺	郺
郻	郻
郼	郼
都	都
郾	郾
郿	郿
鄀	鄀
鄁	鄁
鄂	鄂
鄃	鄃
鄄	鄄
鄅	鄅
鄆	郓
鄇	鄇
鄈	鄈
鄉	乡
鄊	鄊
鄋	鄋
鄌	鄌
鄍	鄍
鄎	鄎
鄏	鄏
鄐	鄐
鄑	鄑
鄒	邹
鄓	鄓
鄔	邬
鄕	鄕
鄖	郧
鄗	鄗
鄘	鄘
鄙	鄙
鄚	鄚
鄛	鄛
鄜	鄜
鄝	鄝
鄞	鄞
鄟	鄟
鄠	鄠
鄡	鄡
鄢	鄢
鄣	鄣
鄤	鄤
鄥	鄥
鄦	鄦
鄧	邓
鄨	鄨
鄩	鄩
鄪	鄪
鄫	鄫
鄬	鄬
鄭	郑
鄮	鄮
鄯	鄯
鄰	邻
鄱	鄱
鄲	郸
鄳	鄳
鄴	邺
鄵	鄵
鄶	郐
鄷	鄷
鄸	鄸
鄹	鄹
鄺	邝
鄻	鄻
鄼	鄼
鄽	鄽
鄾	鄾
鄿	鄿
酀	酀
酁	酁
酂	酂
酃	酃
酄	酄
酅	酅
酆	酆
酇	酂
酈	郦
酉	酉
酊	酊
酋	酋
酌	酌
配	配
酎	酎
酏	酏
酐	酐
酑	酑
酒	酒
酓	酓
酔	酔
酕	酕
酖	酖
酗	酗
酘	酘
酙	酙
酚	酚
酛	酛
酜	酜
酝	酝
酞	酞
酟	酟
酠	酠
酡	酡
酢	酢
酣	酣
酤	酤
酥	酥
酦	酦
酧	酧
酨	酨
酩	酩
酪	酪
酫	酫
酬	酬
酭	酭
酮	酮
酯	酯
酰	酰
酱	酱
酲	酲
酳	酳
酴	酴
酵	酵
酶	酶
酷	酷
酸	酸
酹	酹
酺	酺
酻	酻
酼	酼
酽	酽
酾	酾
酿	酿
醀	醀
醁	醁
醂	醂
醃	醃
醄	醄
醅	醅
醆	醆
醇	醇
醈	醈
醉	醉
醊	醊
醋	醋
醌	醌
醍	醍
醎	醎
醏	醏
醐	醐
醑	醑
醒	醒
醓	醓
醔	醔
醕	醕
醖	醖
醗	醗
醘	醘
醙	醙
醚	醚
醛	醛
醜	丑
醝	醝
醞	酝
醟	醟
醠	醠
醡	醡
醢	醢
醣	醣
醤	醤
醥	醥
醦	醦
醧	醧
醨	醨
醩	醩
醪	醪
醫	医
醬	酱
醭	醭
醮	醮
醯	醯
醰	醰
醱	酦
醲	醲
醳	醳
醴	醴
醵	醵
醶	醶
醷	醷
醸	醸
醹	醹
醺	醺
醻	醻
醼	醼
醽	醽
醾	醾
醿	醿
釀	酿
釁	衅
釂	釂
釃	酾
釄	釄
釅	酽
釆	釆
采	采
釈	釈
釉	釉
释	释
釋	释
里	里
重	重
野	野
量	量
釐	厘
金	金
釒	钅
釓	钆
釔	钇
釕	钌
釖	釖
釗	钊
釘	钉
釙	钋
釚	釚
釛	釛
釜	釜
針	针
釞	釞
釟	釟
釠	釠
釡	釡
釢	釢
釣	钓
釤	钐
釥	釥
釦	釦
釧	钏
釨	釨
釩	钒
釪	釪
釫	釫
釬	釬
釭	釭
釮	釮
釯	釯
釰	釰
釱	釱
釲	釲
釳	釳
釴	釴
釵	钗
釶	釶
釷	钍
釸	釸
釹	钕
釺	钎
釻	釻
釼	釼
釽	釽
釾	釾
釿	釿
鈀	钯
鈁	钫
鈂	鈂
鈃	钘
鈄	钭
鈅	鈅
鈆	鈆
鈇	鈇
鈈	钚
鈉	钠
鈊	鈊
鈋	鈋
鈌	鈌
鈍	钝
鈎	鈎
鈏	鈏
鈐	钤
鈑	钣
鈒	钑
鈓	鈓
鈔	钞
鈕	钮
鈖	鈖
鈗	鈗
鈘	鈘
鈙	鈙
鈚	鈚
鈛	鈛
鈜	鈜
鈝	鈝
鈞	钧
鈟	鈟
鈠	鈠
鈡	鈡
鈢	鈢
鈣	钙
鈤	鈤
鈥	钬
鈦	钛
鈧	钪
鈨	鈨
鈩	鈩
鈪	鈪
鈫	鈫
鈬	鈬
鈭	鈭
鈮	铌
鈯	鈯
鈰	铈
鈱	鈱
鈲	鈲
鈳	钶
鈴	铃
鈵	鈵
鈶	鈶
鈷	钴
鈸	钹
鈹	铍
鈺	钰
鈻	鈻
鈼	鈼
鈽	钸
鈾	铀
鈿	钿
鉀	钾
鉁	鉁
鉂	鉂
鉃	鉃
鉄	鉄
鉅	钜
鉆	鉆
鉇	鉇
鉈	铊
鉉	铉
鉊	鉊
鉋	铇
鉌	鉌
鉍	铋
鉎	鉎
鉏	鉏
鉐	鉐
鉑	铂
鉒	鉒
鉓	鉓
鉔	鉔
鉕	钷
鉖	鉖
鉗	钳
鉘	鉘
鉙	鉙
鉚	铆
鉛	铅
鉜	鉜
鉝	鉝
鉞	钺
鉟	鉟
鉠	鉠
鉡	鉡
鉢	鉢
鉣	鉣
鉤	钩
鉥	鉥
鉦	钲
鉧	鉧
鉨	鉨
鉩	鉩
鉪	鉪
鉫	鉫
鉬	钼
鉭	钽
鉮	鉮
鉯	鉯
鉰	鉰
鉱	鉱
鉲	鉲
鉳	鉳
鉴	鉴
鉵	鉵
鉶	铏
鉷	鉷
鉸	铰
鉹	鉹
鉺	铒
鉻	铬
鉼	鉼
鉽	鉽
鉾	鉾
鉿	铪
銀	银
銁	銁
銂	銂
銃	铳
銄	銄
銅	铜
銆	銆
銇	銇
銈	銈
銉	銉
銊	銊
銋	銋
銌	銌
銍	铚
銎	銎
銏	銏
銐	銐
銑	铣
銒	銒
銓	铨
銔	銔
銕	銕
銖	铢
銗	銗
銘	铭
銙	銙
銚	铫
銛	铦
銜	衔
銝	銝
銞	銞
銟	銟
銠	铑
銡	銡
銢	銢
銣	铷
銤	銤
銥	铱
銦	铟
銧	銧
銨	铵
銩	铥
銪	铕
銫	铯
銬	铐
銭	銭
銮	銮
銯	銯
銰	銰
銱	铞
銲	銲
銳	锐
銴	銴
銵	銵
銶	銶
銷	销
銸	銸
銹	銹
銺	銺
銻	锑
銼	锉
銽	銽
銾	銾
銿	銿
鋀	鋀
鋁	铝
鋂	鋂
鋃	锒
鋄	鋄
鋅	锌
鋆	鋆
鋇	钡
鋈	鋈
鋉	鋉
鋊	鋊
鋋	鋋
鋌	铤
鋍	鋍
鋎	鋎
鋏	铗
鋐	鋐
鋑	鋑
鋒	锋
鋓	鋓
鋔	鋔
鋕	鋕
鋖	鋖
鋗	鋗
鋘	鋘
鋙	铻
鋚	鋚
鋛	鋛
鋜	鋜
鋝	锊
鋞	鋞
鋟	锓
鋠	鋠
鋡	鋡
鋢	鋢
鋣	铘
鋤	锄
鋥	锃
鋦	锔
鋧	鋧
鋨	锇
鋩	铓
鋪	铺
鋫	鋫
鋬	鋬
鋭	鋭
鋮	铖
鋯	锆
鋰	锂
鋱	铽
鋲	鋲
鋳	鋳
鋴	鋴
鋵	鋵
鋶	锍
鋷	鋷
鋸	锯
鋹	鋹
鋺	鋺
鋻	鋻
鋼	钢
鋽	鋽
鋾	鋾
鋿	鋿
錀	錀
錁	锞
錂	錂
錃	錃
錄	录
錅	錅
錆	锖
錇	锫
錈	锩
錉	錉
錊	錊
錋	錋
錌	錌
錍	錍
錎	錎
錏	铔
錐	锥
錑	錑
錒	锕
錓	錓
錔	錔
錕	锟
錖	錖
錗	錗
錘	锤
錙	锱
錚	铮
錛	锛
錜	錜
錝	錝
錞	錞
錟	锬
錠	锭
錡	锜
錢	钱
錣	錣
錤	錤
錥	錥
錦	锦
錧	錧
錨	锚
錩	锠
錪	錪
錫	锡
錬	錬
錭	錭
錮	锢
錯	错
錰	錰
錱	錱
録	録
錳	锰
錴	錴
錵	錵
錶	表
錷	錷
錸	铼
錹	錹
錺	錺
錻	錻
錼	錼
錽	錽
錾	錾
錿	錿
鍀	锝
鍁	鍁
鍂	鍂
鍃	锪
鍄	鍄
鍅	鍅
鍆	钔
鍇	锴
鍈	锳
鍉	鍉
鍊	鍊
鍋	锅
鍌	鍌
鍍	镀
鍎	鍎
鍏	鍏
鍐	鍐
鍑	鍑
鍒	鍒
鍓	鍓
鍔	锷
鍕	鍕
鍖	鍖
鍗	鍗
鍘	铡
鍙	鍙
鍚	钖
鍛	锻
鍜	鍜
鍝	鍝
鍞	鍞
鍟	鍟
鍠	锽
鍡	鍡
鍢	鍢
鍣	鍣
鍤	锸
鍥	锲
鍦	鍦
鍧	鍧
鍨	鍨
鍩	锘
鍪	鍪
鍫	鍫
鍬	锹
鍭	鍭
鍮	鍮
鍯	鍯
鍰	锾
鍱	鍱
鍲	鍲
鍳	鍳
鍴	鍴
鍵	键
鍶	锶
鍷	鍷
鍸	鍸
鍹	鍹
鍺	锗
鍻	鍻
鍼	鍼
鍽	鍽
鍾	钟
鍿	鍿
鎀	鎀
鎁	鎁
鎂	镁
鎃	鎃
鎄	锿
鎅	鎅
鎆	鎆
鎇	镅
鎈	鎈
鎉	鎉
鎊	镑
鎋	鎋
鎌	鎌
鎍	鎍
鎎	鎎
鎏	鎏
鎐	鎐
鎑	鎑
鎒	鎒
鎓	鎓
鎔	镕
鎕	鎕
鎖	锁
鎗	鎗
鎘	镉
鎙	鎙
鎚	鎚
鎛	镈
鎜	鎜
鎝	鎝
鎞	鎞
鎟	鎟
鎠	鎠
鎡	镃
鎢	钨
鎣	蓥
鎤	鎤
鎥	鎥
鎦	镏
鎧	铠
鎨	鎨
鎩	铩
鎪	锼
鎫	鎫
鎬	镐
鎭	鎭
鎮	镇
鎯	鎯
鎰	镒
鎱	鎱
鎲	镋
鎳	镍
鎴	鎴
鎵	镓
鎶	鎶
鎷	鎷
鎸	鎸
鎹	鎹
鎺	鎺
鎻	鎻
鎼	鎼
鎽	鎽
鎾	鎾
鎿	镎
鏀	鏀
鏁	鏁
鏂	鏂
鏃	镞
鏄	鏄
鏅	鏅
鏆	鏆
鏇	镟
鏈	链
鏉	鏉
鏊	鏊
鏋	鏋
鏌	镆
鏍	镙
鏎	鏎
鏏	鏏
鏐	镠
鏑	镝
鏒	鏒
鏓	鏓
鏔	鏔
鏕	鏕
鏖	鏖
鏗	铿
鏘	锵
鏙	鏙
鏚	鏚
鏛	鏛
鏜	镗
鏝	镘
鏞	镛
鏟	铲
鏠	鏠
鏡	镜
鏢	镖
鏣	鏣
鏤	镂
鏥	鏥
鏦	鏦
鏧	鏧
鏨	錾
鏩	鏩
鏪	鏪
鏫	鏫
鏬	鏬
鏭	鏭
鏮	鏮
鏯	鏯
鏰	镚
鏱	鏱
鏲	鏲
鏳	鏳
鏴	鏴
鏵	铧
鏶	鏶
鏷	镤
鏸	鏸
鏹	镪
鏺	鏺
鏻	鏻
鏼	鏼
鏽	锈
鏾	鏾
鏿	鏿
鐀	鐀
鐁	鐁
鐂	鐂
鐃	铙
鐄	鐄
鐅	鐅
鐆	鐆
鐇	鐇
鐈	鐈
鐉	鐉
鐊	鐊
鐋	铴
鐌	鐌
鐍	鐍
鐎	鐎
鐏	鐏
鐐	镣
鐑	鐑
鐒	铹
鐓	镦
鐔	镡
鐕	鐕
鐖	鐖
鐗	鐗
鐘	钟
鐙	镫
鐚	鐚
鐛	鐛
鐜	鐜
鐝	鐝
鐞	鐞
鐟	鐟
鐠	镨
鐡	鐡
鐢	鐢
鐣	鐣
鐤	鐤
鐥	鐥
鐦	锎
鐧	锏
鐨	镄
鐩	鐩
鐪	鐪
鐫	镌
鐬	鐬
鐭	鐭
鐮	镰
鐯	鐯
鐰	鐰
鐱	鐱
鐲	镯
鐳	镭
鐴	鐴
鐵	铁
鐶	镮
鐷	鐷
鐸	铎
鐹	鐹
鐺	铛
鐻	鐻
鐼	鐼
鐽	鐽
鐾	鐾
鐿	镱
鑀	鑀
鑁	鑁
鑂	鑂
鑃	鑃
鑄	铸
鑅	鑅
鑆	鑆
鑇	鑇
鑈	鑈
鑉	鑉
鑊	镬
鑋	鑋
鑌	镔
鑍	鑍
鑎	鑎
鑏	鑏
鑐	鑐
鑑	鑑
鑒	鉴
鑓	鑓
鑔	镲
鑕	锧
鑖	鑖
鑗	鑗
鑘	鑘
鑙	鑙
鑚	鑚
鑛	鑛
鑜	鑜
鑝	鑝
鑞	镴
鑟	鑟
鑠	铄
鑡	鑡
鑢	鑢
鑣	镳
鑤	鑤
鑥	镥
鑦	鑦
鑧	鑧
鑨	鑨
鑩	鑩
鑪	鑪
鑫	鑫
鑬	鑬
鑭	镧
鑮	鑮
鑯	鑯
鑰	钥
鑱	镵
鑲	镶
鑳	鑳
鑴	鑴
鑵	鑵
鑶	鑶
鑷	镊
鑸	鑸
鑹	镩
鑺	鑺
鑻	鑻
鑼	锣
鑽	钻
鑾	銮
鑿	凿
钀	钀
钁	镢
钂	钂
钃	钃
钄	钄
钅	钅
钆	钆
钇	钇
针	针
钉	钉
钊	钊
钋	钋
钌	钌
钍	钍
钎	钎
钏	钏
钐	钐
钑	钑
钒	钒
钓	钓
钔	钔
钕	钕
钖	钖
钗	钗
钘	钘
钙	钙
钚	钚
钛	钛
钜	钜
钝	钝
钞	钞
钟	钟
钠	钠
钡	钡
钢	钢
钣	钣
钤	钤
钥	钥
钦	钦
钧	钧
钨	钨
钩	钩
钪	钪
钫	钫
钬	钬
钭	钭
钮	钮
钯	钯
钰	钰
钱	钱
钲	钲
钳	钳
钴	钴
钵	钵
钶	钶
钷	钷
钸	钸
钹	钹
钺	钺
钻	钻
钼	钼
钽	钽
钾	钾
钿	钿
铀	铀
铁	铁
铂	铂
铃	铃
铄	铄
铅	铅
铆	铆
铇	铇
铈	铈
铉	铉
铊	铊
铋	铋
铌	铌
铍	铍
铎	铎
铏	铏
铐	铐
铑	铑
铒	铒
铓	铓
铔	铔
铕	铕
铖	铖
铗	铗
铘	铘
铙	铙
铚	铚
铛	铛
铜	铜
铝	铝
铞	铞
铟	铟
铠	铠
铡	铡
铢	铢
铣	铣
铤	铤
铥	铥
铦	铦
铧	铧
铨	铨
铩	铩
铪	铪
铫	铫
铬	铬
铭	铭
铮	铮
铯	铯
铰	铰
铱	铱
铲	铲
铳	铳
铴	铴
铵	铵
银	银
铷	铷
铸	铸
铹	铹
铺	铺
铻	铻
铼	铼
铽	铽
链	链
铿	铿
销	销
锁	锁
锂	锂
锃	锃
锄	锄
锅	锅
锆	锆
锇	锇
锈	锈
锉	锉
锊	锊
锋	锋
锌	锌
锍	锍
锎	锎
锏	锏
锐	锐
锑	锑
锒	锒
锓	锓
锔	锔
锕	锕
锖	锖
锗	锗
锘	锘
错	错
锚	锚
锛	锛
锜	锜
锝	锝
锞	锞
锟	锟
锠	锠
锡	锡
锢	锢
锣	锣
锤	锤
锥	锥
锦	锦
锧	锧
锨	锨
锩	锩
锪	锪
锫	锫
锬	锬
锭	锭
键	键
锯	锯
锰	锰
锱	锱
锲	锲
锳	锳
锴	锴
锵	锵
锶	锶
锷	锷
锸	锸
锹	锹
锺	锺
锻	锻
锼	锼
锽	锽
锾	锾
锿	锿
镀	镀
镁	镁
镂	镂
镃	镃
镄	镄
镅	镅
镆	镆
镇	镇
镈	镈
镉	镉
镊	镊
镋	镋
镌	镌
镍	镍
镎	镎
镏	镏
镐	镐
镑	镑
镒	镒
镓	镓
镔	镔
镕	镕
镖	镖
镗	镗
镘	镘
镙	镙
镚	镚
镛	镛
镜	镜
镝	镝
镞	镞
镟	镟
镠	镠
镡	镡
镢	镢
镣	镣
镤	镤
镥	镥
镦	镦
镧	镧
镨	镨
镩	镩
镪	镪
镫	镫
镬	镬
镭	镭
镮	镮
镯	镯
镰	镰
镱	镱
镲	镲
镳	镳
镴	镴
镵	镵
镶	镶
長	长
镸	镸
镹	镹
镺	镺
镻	镻
镼	镼
镽	镽
镾	镾
长	长
門	门
閁	閁
閂	闩
閃	闪
閄	閄
閅	閅
閆	闫
閇	閇
閈	闬
閉	闭
閊	閊
開	开
閌	闶
閍	閍
閎	闳
閏	闰
閐	閐
閑	闲
閒	閒
間	间
閔	闵
閕	閕
閖	閖
閗	閗
閘	闸
閙	閙
閚	閚
閛	閛
閜	閜
閝	閝
閞	閞
閟	閟
閠	閠
閡	阂
関	関
閣	阁
閤	閤
閥	阀
閦	閦
閧	閧
閨	闺
閩	闽
閪	閪
閫	阃
閬	阆
閭	闾
閮	閮
閯	閯
閰	閰
閱	阅
閲	閲
閳	閳
閴	閴
閵	閵
閶	阊
閷	閷
閸	閸
閹	阉
閺	閺
閻	阎
閼	阏
閽	阍
閾	阈
閿	阌
闀	闀
闁	闁
闂	闂
闃	阒
闄	闄
闅	闅
闆	板
闇	闇
闈	闱
闉	闉
闊	阔
闋	阕
闌	阑
闍	阇
闎	闎
闏	闏
闐	阗
闑	闑
闒	阘
闓	闿
闔	阖
闕	阙
闖	闯
闗	闗
闘	闘
闙	闙
闚	闚
闛	闛
關	关
闝	闝
闞	阚
闟	闟
闠	阓
闡	阐
闢	闢
闣	闣
闤	阛
闥	闼
闦	闦
闧	闧
门	门
闩	闩
闪	闪
闫	闫
闬	闬
闭	闭
问	问
闯	闯
闰	闰
闱	闱
闲	闲
闳	闳
间	间
闵	闵
闶	闶
闷	闷
闸	闸
闹	闹
闺	闺
闻	闻
闼	闼
闽	闽
闾	闾
闿	闿
阀	阀
阁	阁
阂	阂
阃	阃
阄	阄
阅	阅
阆	阆
阇	阇
阈	阈
阉	阉
阊	阊
阋	阋
阌	阌
阍	阍
阎	阎
阏	阏
阐	阐
阑	阑
阒	阒
阓	阓
阔	阔
阕	阕
阖	阖
阗	阗
阘	阘
阙	阙
阚	阚
阛	阛
阜	阜
阝	阝
阞	阞
队	队
阠	阠
阡	阡
阢	阢
阣	阣
阤	阤
阥	阥
阦	阦
阧	阧
阨	阨
阩	阩
阪	坂
阫	阫
阬	阬
阭	阭
阮	阮
阯	阯
阰	阰
阱	阱
防	防
阳	阳
阴	阴
阵	阵
阶	阶
阷	阷
阸	阸
阹	阹
阺	阺
阻	阻
阼	阼
阽	阽
阾	阾
阿	阿
陀	陀
陁	陁
陂	陂
陃	陃
附	附
际	际
陆	陆
陇	陇
陈	陈
陉	陉
陊	陊
陋	陋
陌	陌
降	降
陎	陎
陏	陏
限	限
陑	陑
陒	陒
陓	陓
陔	陔
陕	陕
陖	陖
陗	陗
陘	陉
陙	陙
陚	陚
陛	陛
陜	陜
陝	陕
陞	陞
陟	陟
陠	陠
陡	陡
院	院
陣	阵
除	除
陥	陥
陦	陦
陧	陧
陨	陨
险	险
陪	陪
陫	陫
陬	陬
陭	陭
陮	陮
陯	陯
陰	阴
陱	陱
陲	陲
陳	陈
陴	陴
陵	陵
陶	陶
陷	陷
陸	陆
陹	陹
険	険
陻	陻
陼	陼
陽	阳
陾	陾
陿	陿
隀	隀
隁	隁
隂	隂
隃	隃
隄	隄
隅	隅
隆	隆
隇	隇
隈	隈
隉	陧
隊	队
隋	隋
隌	隌
隍	隍
階	阶
随	随
隐	隐
隑	隑
隒	隒
隓	隓
隔	隔
隕	陨
隖	隖
隗	隗
隘	隘
隙	隙
隚	隚
際	际
障	障
隝	隝
隞	隞
隟	隟
隠	隠
隡	隡
隢	隢
隣	隣
隤	隤
隥	隥
隦	隦
隧	隧
隨	随
隩	隩
險	险
隫	隫
隬	隬
隭	隭
隮	隮
隯	隯
隰	隰
隱	隐
隲	隲
隳	隳
隴	陇
隵	隵
隶	隶
隷	隷
隸	隶
隹	隹
隺	隺
隻	只
隼	隼
隽	隽
难	难
隿	隿
雀	雀
雁	雁
雂	雂
雃	雃
雄	雄
雅	雅
集	集
雇	雇
雈	雈
雉	雉
雊	雊
雋	隽
雌	雌
雍	雍
雎	雎
雏	雏
雐	雐
雑	雑
雒	雒
雓	雓
雔	雔
雕	雕
雖	虽
雗	雗
雘	雘
雙	双
雚	雚
雛	雏
雜	杂
雝	雝
雞	鸡
雟	雟
雠	雠
雡	雡
離	离
難	难
雤	雤
雥	雥
雦	雦
雧	雧
雨	雨
雩	雩
雪	雪
雫	雫
雬	雬
雭	雭
雮	雮
雯	雯
雰	雰
雱	雱
雲	云
雳	雳
雴	雴
雵	雵
零	零
雷	雷
雸	雸
雹	雹
雺	雺
電	电
雼	雼
雽	雽
雾	雾
雿	雿
需	需
霁	霁
霂	霂
霃	霃
霄	霄
霅	霅
霆	霆
震	震
霈	霈
霉	霉
霊	霊
霋	霋
霌	霌
霍	霍
霎	霎
霏	霏
霐	霐
霑	霑
霒	霒
霓	霓
霔	霔
霕	霕
霖	霖
霗	霗
霘	霘
霙	霙
霚	霚
霛	霛
霜	霜
霝	霝
霞	霞
霟	霟
霠	霠
霡	霡
霢	霡
霣	霣
霤	霤
霥	霥
霦	霦
霧	雾
霨	霨
霩	霩
霪	霪
霫	霫
霬	霬
霭	霭
霮	霮
霯	霯
霰	霰
霱	霱
露	露
霳	霳
霴	霴
霵	霵
霶	霶
霷	霷
霸	霸
霹	霹
霺	霺
霻	霻
霼	霼
霽	霁
霾	霾
霿	霿
靀	靀
靁	靁
靂	雳
靃	靃
靄	霭
靅	靅
靆	靆
靇	靇
靈	灵
靉	靉
靊	靊
靋	靋
靌	靌
靍	靍
靎	靎
靏	靏
靐	靐
靑	靑
青	青
靓	靓
靔	靔
靕	靕
靖	靖
靗	靗
靘	靘
静	静
靚	靓
靛	靛
靜	静
靝	靝
非	非
靟	靟
靠	靠
靡	靡
面	面
靣	靣
靤	靤
靥	靥
靦	腼
靧	靧
靨	靥
革	革
靪	靪
靫	靫
靬	靬
靭	靭
靮	靮
靯	靯
靰	靰
靱	靱
靲	靲
靳	靳
靴	靴
靵	靵
靶	靶
靷	靷
靸	靸
靹	靹
靺	靺
靻	靻
靼	靼
靽	靽
靾	靾
靿	靿
鞀	鼗
鞁	鞁
鞂	鞂
鞃	鞃
鞄	鞄
鞅	鞅
鞆	鞆
鞇	鞇
鞈	鞈
鞉	鞉
鞊	鞊
鞋	鞋
鞌	鞌
鞍	鞍
鞎	鞎
鞏	巩
鞐	鞐
鞑	鞑
鞒	鞒
鞓	鞓
鞔	鞔
鞕	鞕
鞖	鞖
鞗	鞗
鞘	鞘
鞙	鞙
鞚	鞚
鞛	鞛
鞜	鞜
鞝	绱
鞞	鞞
鞟	鞟
鞠	鞠
鞡	鞡
鞢	鞢
鞣	鞣
鞤	鞤
鞥	鞥
鞦	鞦
鞧	鞧
鞨	鞨
鞩	鞩
鞪	鞪
鞫	鞫
鞬	鞬
鞭	鞭
鞮	鞮
鞯	鞯
鞰	鞰
鞱	鞱
鞲	鞲
鞳	鞳
鞴	鞴
鞵	鞵
鞶	鞶
鞷	鞷
鞸	鞸
鞹	鞹
鞺	鞺
鞻	鞻
鞼	鞼
鞽	鞒
鞾	鞾
鞿	鞿
韀	韀
韁	缰
韂	韂
韃	鞑
韄	韄
韅	韅
韆	韆
韇	韇
韈	韈
韉	鞯
韊	韊
韋	韦
韌	韧
韍	韨
韎	韎
韏	韏
韐	韐
韑	韑
韒	韒
韓	韩
韔	韔
韕	韕
韖	韖
韗	韗
韘	韘
韙	韪
韚	韚
韛	韛
韜	韬
韝	韝
韞	韫
韟	韟
韠	韠
韡	韡
韢	韢
韣	韣
韤	韤
韥	韥
韦	韦
韧	韧
韨	韨
韩	韩
韪	韪
韫	韫
韬	韬
韭	韭
韮	韮
韯	韯
韰	韰
韱	韱
韲	韲
音	音
韴	韴
韵	韵
韶	韶
韷	韷
韸	韸
韹	韹
韺	韺
韻	韵
韼	韼
韽	韽
韾	韾
響	响
頀	頀
頁	页
頂	顶
頃	顷
頄	頄
項	项
順	顺
頇	顸
須	须
頉	頉
頊	顼
頋	頋
頌	颂
頍	頍
頎	颀
頏	颃
預	预
頑	顽
頒	颁
頓	顿
頔	頔
頕	頕
頖	頖
頗	颇
領	领
頙	頙
頚	頚
頛	頛
頜	颌
頝	頝
頞	頞
頟	頟
頠	頠
頡	颉
頢	頢
頣	頣
頤	颐
頥	頥
頦	颏
頧	頧
頨	頨
頩	頩
頪	頪
頫	頫
頬	頬
頭	头
頮	颒
頯	頯
頰	颊
頱	頱
頲	颋
頳	頳
頴	颕
頵	頵
頶	頶
頷	颔
頸	颈
頹	颓
頺	頺
頻	频
頼	頼
頽	頽
頾	頾
頿	頿
顀	顀
顁	顁
顂	顂
顃	顃
顄	顄
顅	顅
顆	颗
顇	顇
顈	顈
顉	顉
顊	顊
顋	顋
題	题
額	额
顎	颚
顏	颜
顐	顐
顑	顑
顒	颙
顓	颛
顔	顔
顕	顕
顖	顖
顗	顗
願	愿
顙	颡
顚	顚
顛	颠
顜	顜
顝	顝
類	类
顟	顟
顠	顠
顡	顡
顢	颟
顣	顣
顤	顤
顥	颢
顦	顦
顧	顾
顨	顨
顩	顩
顪	顪
顫	颤
顬	颥
顭	顭
顮	顮
顯	显
顰	颦
顱	颅
顲	顲
顳	颞
顴	颧
页	页
顶	顶
顷	顷
顸	顸
项	项
顺	顺
须	须
顼	顼
顽	顽
顾	顾
顿	顿
颀	颀
颁	颁
颂	颂
颃	颃
预	预
颅	颅
领	领
颇	颇
颈	颈
颉	颉
颊	颊
颋	颋
颌	颌
颍	颍
颎	颎
颏	颏
颐	颐
频	频
颒	颒
颓	颓
颔	颔
颕	颕
颖	颖
颗	颗
题	题
颙	颙
颚	颚
颛	颛
颜	颜
额	额
颞	颞
颟	颟
颠	颠
颡	颡
颢	颢
颣	颣
颤	颤
颥	颥
颦	颦
颧	颧
風	风
颩	颩
颪	颪
颫	颫
颬	颬
颭	飐
颮	飑
颯	飒
颰	颰
颱	台
颲	颲
颳	刮
颴	颴
颵	颵
颶	飓
颷	颷
颸	飔
颹	颹
颺	飏
颻	飖
颼	飕
颽	颽
颾	颾
颿	颿
飀	飗
飁	飁
飂	飂
飃	飃
飄	飘
飅	飅
飆	飙
飇	飇
飈	飚
飉	飉
飊	飊
飋	飋
飌	飌
飍	飍
风	风
飏	飏
飐	飐
飑	飑
飒	飒
飓	飓
飔	飔
飕	飕
飖	飖
飗	飗
飘	飘
飙	飙
飚	飚
飛	飞
飜	飜
飝	飝
飞	飞
食	食
飠	饣
飡	飡
飢	饥
飣	饤
飤	飤
飥	饦
飦	飦
飧	飧
飨	飨
飩	饨
飪	饪
飫	饫
飬	飬
飭	饬
飮	飮
飯	饭
飰	飰
飱	飱
飲	饮
飳	飳
飴	饴
飵	飵
飶	飶
飷	飷
飸	飸
飹	飹
飺	飺
飻	飻
飼	饲
飽	饱
飾	饰
飿	饳
餀	餀
餁	餁
餂	餂
餃	饺
餄	饸
餅	饼
餆	餆
餇	餇
餈	餈
餉	饷
養	养
餋	餋
餌	饵
餍	餍
餎	饹
餏	饻
餐	餐
餑	饽
餒	馁
餓	饿
餔	餔
餕	馂
餖	饾
餗	餗
餘	余
餙	餙
餚	肴
餛	馄
餜	馃
餝	餝
餞	饯
餟	餟
餠	餠
餡	馅
餢	餢
餣	餣
餤	餤
餥	餥
餦	餦
餧	餧
館	馆
餩	餩
餪	餪
餫	餫
餬	餬
餭	餭
餮	餮
餯	餯
餰	餰
餱	糇
餲	餲
餳	饧
餴	餴
餵	餵
餶	馉
餷	馇
餸	餸
餹	餹
餺	馎
餻	餻
餼	饩
餽	餽
餾	馏
餿	馊
饀	饀
饁	馌
饂	饂
饃	馍
饄	饄
饅	馒
饆	饆
饇	饇
饈	馐
饉	馑
饊	馓
饋	馈
饌	馔
饍	饍
饎	饎
饏	饏
饐	饐
饑	饑
饒	饶
饓	饓
饔	饔
饕	饕
饖	饖
饗	飨
饘	饘
饙	饙
饚	饚
饛	饛
饜	餍
饝	饝
饞	馋
饟	饟
饠	饠
饡	饡
饢	馕
饣	饣
饤	饤
饥	饥
饦	饦
饧	饧
饨	饨
饩	饩
饪	饪
饫	饫
饬	饬
饭	饭
饮	饮
饯	饯
饰	饰
饱	饱
饲	饲
饳	饳
饴	饴
饵	饵
饶	饶
饷	饷
饸	饸
饹	饹
饺	饺
饻	饻
饼	饼
饽	饽
饾	饾
饿	饿
馀	馀
馁	馁
馂	馂
馃	馃
馄	馄
馅	馅
馆	馆
馇	馇
馈	馈
馉	馉
馊	馊
馋	馋
馌	馌
馍	馍
馎	馎
馏	馏
馐	馐
馑	馑
馒	馒
馓	馓
馔	馔
馕	馕
首	首
馗	馗
馘	馘
香	香
馚	馚
馛	馛
馜	馜
馝	馝
馞	馞
馟	馟
馠	馠
馡	馡
馢	馢
馣	馣
馤	馤
馥	馥
馦	馦
馧	馧
馨	馨
馩	馩
馪	馪
馫	馫
馬	马
馭	驭
馮	冯
馯	馯
馰	馰
馱	驮
馲	馲
馳	驰
馴	驯
馵	馵
馶	馶
馷	馷
馸	馸
馹	驲
馺	馺
馻	馻
馼	馼
馽	馽
馾	馾
馿	馿
駀	駀
駁	驳
駂	駂
駃	駃
駄	駄
駅	駅
駆	駆
駇	駇
駈	駈
駉	駉
駊	駊
駋	駋
駌	駌
駍	駍
駎	駎
駏	駏
駐	驻
駑	驽
駒	驹
駓	駓
駔	驵
駕	驾
駖	駖
駗	駗
駘	骀
駙	驸
駚	駚
駛	驶
駜	駜
駝	驼
駞	駞
駟	驷
駠	駠
駡	駡
駢	骈
駣	駣
駤	駤
駥	駥
駦	駦
駧	駧
駨	駨
駩	駩
駪	駪
駫	駫
駬	駬
駭	骇
駮	駮
駯	駯
駰	骃
駱	骆
駲	駲
駳	駳
駴	駴
駵	駵
駶	駶
駷	駷
駸	骎
駹	駹
駺	駺
駻	駻
駼	駼
駽	駽
駾	駾
駿	骏
騀	騀
騁	骋
騂	骍
騃	騃
騄	騄
騅	骓
騆	騆
騇	騇
騈	騈
騉	騉
騊	騊
騋	騋
騌	骔
騍	骒
騎	骑
騏	骐
騐	騐
騑	騑
騒	騒
験	験
騔	騔
騕	騕
騖	骛
騗	騗
騘	騘
騙	骗
騚	騚
騛	騛
騜	騜
騝	騝
騞	騞
騟	騟
騠	騠
騡	騡
騢	騢
騣	騣
騤	骙
騥	騥
騦	騦
騧	騧
騨	騨
騩	騩
騪	騪
騫	骞
騬	騬
騭	骘
騮	骝
騯	騯
騰	腾
騱	騱
騲	騲
騳	騳
騴	騴
騵	騵
騶	驺
騷	骚
騸	骟
騹	騹
騺	騺
騻	騻
騼	騼
騽	騽
騾	骡
騿	騿
驀	蓦
驁	骜
驂	骖
驃	骠
驄	骢
驅	驱
驆	驆
驇	驇
驈	驈
驉	驉
驊	骅
驋	驋
驌	骕
驍	骁
驎	驎
驏	骣
驐	驐
驑	驑
驒	驒
驓	驓
驔	驔
驕	骄
驖	驖
驗	验
驘	驘
驙	驙
驚	惊
驛	驿
驜	驜
驝	驝
驞	驞
驟	骤
驠	驠
驡	驡
驢	驴
驣	驣
驤	骧
驥	骥
驦	骦
驧	驧
驨	驨
驩	驩
驪	骊
驫	骉
马	马
驭	驭
驮	驮
驯	驯
驰	驰
驱	驱
驲	驲
驳	驳
驴	驴
驵	驵
驶	驶
驷	驷
驸	驸
驹	驹
驺	驺
驻	驻
驼	驼
驽	驽
驾	驾
驿	驿
骀	骀
骁	骁
骂	骂
骃	骃
骄	骄
骅	骅
骆	骆
骇	骇
骈	骈
骉	骉
骊	骊
骋	骋
验	验
骍	骍
骎	骎
骏	骏
骐	骐
骑	骑
骒	骒
骓	骓
骔	骔
骕	骕
骖	骖
骗	骗
骘	骘
骙	骙
骚	骚
骛	骛
骜	骜
骝	骝
骞	骞
骟	骟
骠	骠
骡	骡
骢	骢
骣	骣
骤	骤
骥	骥
骦	骦
骧	骧
骨	骨
骩	骩
骪	骪
骫	骫
骬	骬
骭	骭
骮	骮
骯	肮
骰	骰
骱	骱
骲	骲
骳	骳
骴	骴
骵	骵
骶	骶
骷	骷
骸	骸
骹	骹
骺	骺
骻	骻
骼	骼
骽	骽
骾	骾
骿	骿
髀	髀
髁	髁
髂	髂
髃	髃
髄	髄
髅	髅
髆	髆
髇	髇
髈	髈
髉	髉
髊	髊
髋	髋
髌	髌
髍	髍
髎	髎
髏	髅
髐	髐
髑	髑
髒	脏
髓	髓
體	体
髕	髌
髖	髋
髗	髗
高	高
髙	髙
髚	髚
髛	髛
髜	髜
髝	髝
髞	髞
髟	髟
髠	髠
髡	髡
髢	髢
髣	髣
髤	髤
髥	髥
髦	髦
髧	髧
髨	髨
髩	髩
髪	髪
髫	髫
髬	髬
髭	髭
髮	发
髯	髯
髰	髰
髱	髱
髲	髲
髳	髳
髴	髴
髵	髵
髶	髶
髷	髷
髸	髸
髹	髹
髺	髺
髻	髻
髼	髼
髽	髽
髾	髾
髿	髿
鬀	鬀
鬁	鬁
鬂	鬂
鬃	鬃
鬄	鬄
鬅	鬅
鬆	松
鬇	鬇
鬈	鬈
鬉	鬉
鬊	鬊
鬋	鬋
鬌	鬌
鬍	胡
鬎	鬎
鬏	鬏
鬐	鬐
鬑	鬑
鬒	鬒
鬓	鬓
鬔	鬔
鬕	鬕
鬖	鬖
鬗	鬗
鬘	鬘
鬙	鬙
鬚	须
鬛	鬛
鬜	鬜
鬝	鬝
鬞	鬞
鬟	鬟
鬠	鬠
鬡	鬡
鬢	鬓
鬣	鬣
鬤	鬤
鬥	斗
鬦	鬦
鬧	闹
鬨	鬨
鬩	阋
鬪	鬪
鬫	鬫
鬬	鬬
鬭	鬭
鬮	阄
鬯	鬯
鬰	鬰
鬱	郁
鬲	鬲
鬳	鬳
鬴	鬴
鬵	鬵
鬶	鬶
鬷	鬷
鬸	鬸
鬹	鬶
鬺	鬺
鬻	鬻
鬼	鬼
鬽	鬽
鬾	鬾
鬿	鬿
魀	魀
魁	魁
魂	魂
魃	魃
魄	魄
魅	魅
魆	魆
魇	魇
魈	魈
魉	魉
魊	魊
魋	魋
魌	魌
魍	魍
魎	魉
魏	魏
魐	魐
魑	魑
魒	魒
魓	魓
魔	魔
魕	魕
魖	魖
魗	魗
魘	魇
魙	魙
魚	鱼
魛	鱽
魜	魜
魝	魝
魞	魞
魟	魟
魠	魠
魡	魡
魢	鱾
魣	魣
魤	魤
魥	魥
魦	魦
魧	魧
魨	鲀
魩	魩
魪	魪
魫	魫
魬	魬
魭	魭
魮	魮
魯	鲁
魰	魰
魱	魱
魲	魲
魳	魳
魴	鲂
魵	魵
魶	魶
魷	鱿
魸	魸
魹	魹
魺	鲄
魻	魻
魼	魼
魽	魽
魾	魾
魿	魿
鮀	鮀
鮁	鲅
鮂	鮂
鮃	鲆
鮄	鮄
鮅	鮅
鮆	鮆
鮇	鮇
鮈	鮈
鮉	鮉
鮊	鲌
鮋	鲉
鮌	鮌
鮍	鲏
鮎	鮎
鮏	鮏
鮐	鲐
鮑	鲍
鮒	鲋
鮓	鲊
鮔	鮔
鮕	鮕
鮖	鮖
鮗	鮗
鮘	鮘
鮙	鮙
鮚	鲒
鮛	鮛
鮜	鲘
鮝	鮝
鮞	鲕
鮟	鮟
鮠	鮠
鮡	鮡
鮢	鮢
鮣	鮣
鮤	鮤
鮥	鮥
鮦	鲖
鮧	鮧
鮨	鮨
鮩	鮩
鮪	鲔
鮫	鲛
鮬	鮬
鮭	鲑
鮮	鲜
鮯	鮯
鮰	鮰
鮱	鮱
鮲	鮲
鮳	鲓
鮴	鮴
鮵	鮵
鮶	鲪
鮷	鮷
鮸	鮸
鮹	鮹
鮺	鲝
鮻	鮻
鮼	鮼
鮽	鮽
鮾	鮾
鮿	鮿
鯀	鲧
鯁	鲠
鯂	鯂
鯃	鯃
鯄	鯄
鯅	鯅
鯆	鯆
鯇	鲩
鯈	鯈
鯉	鲤
鯊	鲨
鯋	鯋
鯌	鯌
鯍	鯍
鯎	鯎
鯏	鯏
鯐	鯐
鯑	鯑
鯒	鲬
鯓	鯓
鯔	鲻
鯕	鲯
鯖	鲭
鯗	鲞
鯘	鯘
鯙	鯙
鯚	鯚
鯛	鲷
鯜	鯜
鯝	鲴
鯞	鯞
鯟	鯟
鯠	鯠
鯡	鲱
鯢	鲵
鯣	鯣
鯤	鲲
鯥	鯥
鯦	鯦
鯧	鲳
鯨	鲸
鯩	鯩
鯪	鲮
鯫	鲰
鯬	鯬
鯭	鯭
鯮	鯮
鯯	鯯
鯰	鯰
鯱	鯱
鯲	鯲
鯳	鯳
鯴	鲺
鯵	鯵
鯶	鯶
鯷	鳀
鯸	鯸
鯹	鯹
鯺	鯺
鯻	鯻
鯼	鯼
鯽	鲫
鯾	鯾
鯿	鳊
鰀	鰀
鰁	鳈
鰂	鲗
鰃	鳂
鰄	鰄
鰅	鰅
鰆	鰆
鰇	鰇
鰈	鲽
鰉	鳇
鰊	鰊
鰋	鰋
鰌	鰌
鰍	鳅
鰎	鰎
鰏	鲾
鰐	鰐
鰑	鰑
鰒	鳆
鰓	鳃
鰔	鰔
鰕	鰕
鰖	鰖
鰗	鰗
鰘	鰘
鰙	鰙
鰚	鰚
鰛	鰛
鰜	鳒
鰝	鰝
鰞	鰞
鰟	鳑
鰠	鳋
鰡	鰡
鰢	鰢
鰣	鲥
鰤	鰤
鰥	鳏
鰦	鰦
鰧	鰧
鰨	鳎
鰩	鳐
鰪	鰪
鰫	鰫
鰬	鰬
鰭	鳍
鰮	鳁
鰯	鰯
鰰	鰰
鰱	鲢
鰲	鳌
鰳	鳓
鰴	鰴
鰵	鳘
鰶	鰶
鰷	鲦
鰸	鰸
鰹	鲣
鰺	鲹
鰻	鳗
鰼	鳛
鰽	鰽
鰾	鳔
鰿	鰿
鱀	鱀
鱁	鱁
鱂	鳉
鱃	鱃
鱄	鱄
鱅	鳙
鱆	鱆
鱇	鱇
鱈	鳕
鱉	鳖
鱊	鱊
鱋	鱋
鱌	鱌
鱍	鱍
鱎	鱎
鱏	鱏
鱐	鱐
鱑	鱑
鱒	鳟
鱓	鱓
鱔	鳝
鱕	鱕
鱖	鳜
鱗	鳞
鱘	鲟
鱙	鱙
鱚	鱚
鱛	鱛
鱜	鱜
鱝	鲼
鱞	鱞
鱟	鲎
鱠	鲙
鱡	鱡
鱢	鱢
鱣	鳣
鱤	鳡
鱥	鱥
鱦	鱦
鱧	鳢
鱨	鲿
鱩	鱩
鱪	鱪
鱫	鱫
鱬	鱬
鱭	鲚
鱮	鱮
鱯	鳠
鱰	鱰
鱱	鱱
鱲	鱲
鱳	鱳
鱴	鱴
鱵	鱵
鱶	鱶
鱷	鳄
鱸	鲈
鱹	鱹
鱺	鲡
鱻	鱻
鱼	鱼
鱽	鱽
鱾	鱾
鱿	鱿
鲀	鲀
鲁	鲁
鲂	鲂
鲃	鲃
鲄	鲄
鲅	鲅
鲆	鲆
鲇	鲇
鲈	鲈
鲉	鲉
鲊	鲊
鲋	鲋
鲌	鲌
鲍	鲍
鲎	鲎
鲏	鲏
鲐	鲐
鲑	鲑
鲒	鲒
鲓	鲓
鲔	鲔
鲕	鲕
鲖	鲖
鲗	鲗
鲘	鲘
鲙	鲙
鲚	鲚
鲛	鲛
鲜	鲜
鲝	鲝
鲞	鲞
鲟	鲟
鲠	鲠
鲡	鲡
鲢	鲢
鲣	鲣
鲤	鲤
鲥	鲥
鲦	鲦
鲧	鲧
鲨	鲨
鲩	鲩
鲪	鲪
鲫	鲫
鲬	鲬
鲭	鲭
鲮	鲮
鲯	鲯
鲰	鲰
鲱	鲱
鲲	鲲
鲳	鲳
鲴	鲴
鲵	鲵
鲶	鲶
鲷	鲷
鲸	鲸
鲹	鲹
鲺	鲺
鲻	鲻
鲼	鲼
鲽	鲽
鲾	鲾
鲿	鲿
鳀	鳀
鳁	鳁
鳂	鳂
鳃	鳃
鳄	鳄
鳅	鳅
鳆	鳆
鳇	鳇
鳈	鳈
鳉	鳉
鳊	鳊
鳋	鳋
鳌	鳌
鳍	鳍
鳎	鳎
鳏	鳏
鳐	鳐
鳑	鳑
鳒	鳒
鳓	鳓
鳔	鳔
鳕	鳕
鳖	鳖
鳗	鳗
鳘	鳘
鳙	鳙
鳚	鳚
鳛	鳛
鳜	鳜
鳝	鳝
鳞	鳞
鳟	鳟
鳠	鳠
鳡	鳡
鳢	鳢
鳣	鳣
鳤	鳤
鳥	鸟
鳦	鳦
鳧	凫
鳨	鳨
鳩	鸠
鳪	鳪
鳫	鳫
鳬	鳬
鳭	鳭
鳮	鳮
鳯	鳯
鳰	鳰
鳱	鳱
鳲	鸤
鳳	凤
鳴	鸣
鳵	鳵
鳶	鸢
鳷	鳷
鳸	鳸
鳹	鳹
鳺	鳺
鳻	鳻
鳼	鳼
鳽	鳽
鳾	鳾
鳿	鳿
鴀	鴀
鴁	鴁
鴂	鴂
鴃	鴃
鴄	鴄
鴅	鴅
鴆	鸩
鴇	鸨
鴈	鴈
鴉	鸦
鴊	鴊
鴋	鴋
鴌	鴌
鴍	鴍
鴎	鴎
鴏	鴏
鴐	鴐
鴑	鴑
鴒	鸰
鴓	鴓
鴔	鴔
鴕	鸵
鴖	鴖
鴗	鴗
鴘	鴘
鴙	鴙
鴚	鴚
鴛	鸳
鴜	鴜
鴝	鸲
鴞	鸮
鴟	鸱
鴠	鴠
鴡	鴡
鴢	鴢
鴣	鸪
鴤	鴤
鴥	鴥
鴦	鸯
鴧	鴧
鴨	鸭
鴩	鴩
鴪	鴪
鴫	鴫
鴬	鴬
鴭	鴭
鴮	鴮
鴯	鸸
鴰	鸹
鴱	鴱
鴲	鴲
鴳	鴳
鴴	鸻
鴵	鴵
鴶	鴶
鴷	鴷
鴸	鴸
鴹	鴹
鴺	鴺
鴻	鸿
鴼	鴼
鴽	鴽
鴾	鴾
鴿	鸽
鵀	鵀
鵁	鵁
鵂	鸺
鵃	鸼
鵄	鵄
鵅	鵅
鵆	鵆
鵇	鵇
鵈	鵈
鵉	鵉
鵊	鵊
鵋	鵋
鵌	鵌
鵍	鵍
鵎	鵎
鵏	鵏
鵐	鹀
鵑	鹃
鵒	鹆
鵓	鹁
鵔	鵔
鵕	鵕
鵖	鵖
鵗	鵗
鵘	鵘
鵙	鵙
鵚	鵚
鵛	鵛
鵜	鹈
鵝	鹅
鵞	鵞
鵟	鵟
鵠	鹄
鵡	鹉
鵢	鵢
鵣	鵣
鵤	鵤
鵥	鵥
鵦	鵦
鵧	鵧
鵨	鵨
鵩	鵩
鵪	鹌
鵫	鵫
鵬	鹏
鵭	鵭
鵮	鹐
鵯	鹎
鵰	鵰
鵱	鵱
鵲	鹊
鵳	鵳
鵴	鵴
鵵	鵵
鵶	鵶
鵷	鹓
鵸	鵸
鵹	鵹
鵺	鵺
鵻	鵻
鵼	鵼
鵽	鵽
鵾	鹍
鵿	鵿
鶀	鶀
鶁	鶁
鶂	鶂
鶃	鶃
鶄	鶄
鶅	鶅
鶆	鶆
鶇	鸫
鶈	鶈
鶉	鹑
鶊	鹒
鶋	鶋
鶌	鶌
鶍	鶍
鶎	鶎
鶏	鶏
鶐	鶐
鶑	鶑
鶒	鶒
鶓	鹋
鶔	鶔
鶕	鶕
鶖	鹙
鶗	鶗
鶘	鹕
鶙	鶙
鶚	鹗
鶛	鶛
鶜	鶜
鶝	鶝
鶞	鶞
鶟	鶟
鶠	鶠
鶡	鹖
鶢	鶢
鶣	鶣
鶤	鶤
鶥	鹛
鶦	鶦
鶧	鶧
鶨	鶨
鶩	鹜
鶪	鶪
鶫	鶫
鶬	鸧
鶭	鶭
鶮	鶮
鶯	莺
鶰	鶰
鶱	鶱
鶲	鹟
鶳	鶳
鶴	鹤
鶵	鶵
鶶	鶶
鶷	鶷
鶸	鶸
鶹	鹠
鶺	鹡
鶻	鹘
鶼	鹣
鶽	鶽
鶾	鶾
鶿	鹚
鷀	鷀
鷁	鹢
鷂	鹞
鷃	鷃
鷄	鷄
鷅	鷅
鷆	鷆
鷇	鷇
鷈	鷈
鷉	鷉
鷊	鹝
鷋	鷋
鷌	鷌
鷍	鷍
鷎	鷎
鷏	鷏
鷐	鷐
鷑	鷑
鷒	鷒
鷓	鹧
鷔	鷔
鷕	鷕
鷖	鹥
鷗	鸥
鷘	鷘
鷙	鸷
鷚	鹨
鷛	鷛
鷜	鷜
鷝	鷝
鷞	鷞
鷟	鷟
鷠	鷠
鷡	鷡
鷢	鷢
鷣	鷣
鷤	鷤
鷥	鸶
鷦	鹪
鷧	鷧
鷨	鷨
鷩	鷩
鷪	鷪
鷫	鹔
鷬	鷬
鷭	鷭
鷮	鷮
鷯	鹩
鷰	鷰
鷱	鷱
鷲	鹫
鷳	鹇
鷴	鷴
鷵	鷵
鷶	鷶
鷷	鷷
鷸	鹬
鷹	鹰
鷺	鹭
鷻	鷻
鷼	鷼
鷽	鸴
鷾	鷾
鷿	鷿
鸀	鸀
鸁	鸁
鸂	鸂
鸃	鸃
鸄	鸄
鸅	鸅
鸆	鸆
鸇	鹯
鸈	鸈
鸉	鸉
鸊	鸊
鸋	鸋
鸌	鹱
鸍	鸍
鸎	鸎
鸏	鹲
鸐	鸐
鸑	鸑
鸒	鸒
鸓	鸓
鸔	鸔
鸕	鸬
鸖	鸖
鸗	鸗
鸘	鹴
鸙	鸙
鸚	鹦
鸛	鹳
鸜	鸜
鸝	鹂
鸞	鸾
鸟	鸟
鸠	鸠
鸡	鸡
鸢	鸢
鸣	鸣
鸤	鸤
鸥	鸥
鸦	鸦
鸧	鸧
鸨	鸨
鸩	鸩
鸪	鸪
鸫	鸫
鸬	鸬
鸭	鸭
鸮	鸮
鸯	鸯
鸰	鸰
鸱	鸱
鸲	鸲
鸳	鸳
鸴	鸴
鸵	鸵
鸶	鸶
鸷	鸷
鸸	鸸
鸹	鸹
鸺	鸺
鸻	鸻
鸼	鸼
鸽	鸽
鸾	鸾
鸿	鸿
鹀	鹀
鹁	鹁
鹂	鹂
鹃	鹃
鹄	鹄
鹅	鹅
鹆	鹆
鹇	鹇
鹈	鹈
鹉	鹉
鹊	鹊
鹋	鹋
鹌	鹌
鹍	鹍
鹎	鹎
鹏	鹏
鹐	鹐
鹑	鹑
鹒	鹒
鹓	鹓
鹔	鹔
鹕	鹕
鹖	鹖
鹗	鹗
鹘	鹘
鹙	鹙
鹚	鹚
鹛	鹛
鹜	鹜
鹝	鹝
鹞	鹞
鹟	鹟
鹠	鹠
鹡	鹡
鹢	鹢
鹣	鹣
鹤	鹤
鹥	鹥
鹦	鹦
鹧	鹧
鹨	鹨
鹩	鹩
鹪	鹪
鹫	鹫
鹬	鹬
鹭	鹭
鹮	鹮
鹯	鹯
鹰	鹰
鹱	鹱
鹲	鹲
鹳	鹳
鹴	鹴
鹵	卤
鹶	鹶
鹷	鹷
鹸	鹸
鹹	咸
鹺	鹾
鹻	鹻
鹼	硷
鹽	盐
鹾	鹾
鹿	鹿
麀	麀
麁	麁
麂	麂
麃	麃
麄	麄
麅	麅
麆	麆
麇	麇
麈	麈
麉	麉
麊	麊
麋	麋
麌	麌
麍	麍
麎	麎
麏	麏
麐	麐
麑	麑
麒	麒
麓	麓
麔	麔
麕	麕
麖	麖
麗	丽
麘	麘
麙	麙
麚	麚
麛	麛
麜	麜
麝	麝
麞	麞
麟	麟
麠	麠
麡	麡
麢	麢
麣	麣
麤	麤
麥	麦
麦	麦
麧	麧
麨	麨
麩	麸
麪	麪
麫	麫
麬	麬
麭	麭
麮	麮
麯	麯
麰	麰
麱	麱
麲	麲
麳	麳
麴	麴
麵	面
麶	麶
麷	麷
麸	麸
麹	麹
麺	麺
麻	麻
麼	么
麽	么
麾	麾
麿	麿
黀	黀
黁	黁
黂	黂
黃	黄
黄	黄
黅	黅
黆	黆
黇	黇
黈	黈
黉	黉
黊	黊
黋	黋
黌	黉
黍	黍
黎	黎
黏	黏
黐	黐
黑	黑
黒	黒
黓	黓
黔	黔
黕	黕
黖	黖
黗	黗
默	默
黙	黙
黚	黚
黛	黛
黜	黜
黝	黝
點	点
黟	黟
黠	黠
黡	黡
黢	黢
黣	黣
黤	黤
黥	黥
黦	黦
黧	黧
黨	党
黩	黩
黪	黪
黫	黫
黬	黬
黭	黭
黮	黮
黯	黯
黰	黰
黱	黱
黲	黪
黳	黳
黴	黴
黵	黵
黶	黡
黷	黩
黸	黸
黹	黹
黺	黺
黻	黻
黼	黼
黽	黾
黾	黾
黿	鼋
鼀	鼀
鼁	鼁
鼂	鼂
鼃	鼃
鼄	鼄
鼅	鼅
鼆	鼆
鼇	鼇
鼈	鼈
鼉	鼍
鼊	鼊
鼋	鼋
鼌	鼌
鼍	鼍
鼎	鼎
鼏	鼏
鼐	鼐
鼑	鼑
鼒	鼒
鼓	鼓
鼔	鼔
鼕	鼕
鼖	鼖
鼗	鼗
鼘	鼘
鼙	鼙
鼚	鼚
鼛	鼛
鼜	鼜
鼝	鼝
鼞	鼞
鼟	鼟
鼠	鼠
鼡	鼡
鼢	鼢
鼣	鼣
鼤	鼤
鼥	鼥
鼦	鼦
鼧	鼧
鼨	鼨
鼩	鼩
鼪	鼪
鼫	鼫
鼬	鼬
鼭	鼭
鼮	鼮
鼯	鼯
鼰	鼰
鼱	鼱
鼲	鼲
鼳	鼳
鼴	鼹
鼵	鼵
鼶	鼶
鼷	鼷
鼸	鼸
鼹	鼹
鼺	鼺
鼻	鼻
鼼	鼼
鼽	鼽
鼾	鼾
鼿	鼿
齀	齀
齁	齁
齂	齂
齃	齃
齄	齄
齅	齅
齆	齆
齇	齇
齈	齈
齉	齉
齊	齐
齋	斋
齌	齌
齍	齍
齎	赍
齏	齑
齐	齐
齑	齑
齒	齿
齓	齓
齔	龀
齕	龁
齖	齖
齗	龂
齘	齘
齙	龅
齚	齚
齛	齛
齜	龇
齝	齝
齞	齞
齟	龃
齠	龆
齡	龄
齢	齢
齣	齣
齤	齤
齥	齥
齦	龈
齧	齧
齨	齨
齩	齩
齪	龊
齫	齫
齬	龉
齭	齭
齮	齮
齯	齯
齰	齰
齱	齱
齲	龋
齳	齳
齴	齴
齵	齵
齶	腭
齷	龌
齸	齸
齹	齹
齺	齺
齻	齻
齼	齼
齽	齽
齾	齾
齿	齿
龀	龀
龁	龁
龂	龂
龃	龃
龄	龄
龅	龅
龆	龆
龇	龇
龈	龈
龉	龉
龊	龊
龋	龋
龌	龌
龍	龙
龎	厐
龏	龏
龐	庞
龑	龑
龒	龒
龓	龓
龔	龚
龕	龛
龖	龖
龗	龗
龘	龘
龙	龙
龚	龚
龛	龛
龜	龟
龝	龝
龞	龞
龟	龟
龠	龠
龡	龡
龢	龢
龣	龣
龤	龤
龥	龥
龦	龦
龧	龧
龨	龨
龩	龩
龪	龪
龫	龫
龬	龬
龭	龭
龮	龮
龯	龯
龰	龰
龱	龱
龲	龲
龳	龳
龴	龴
龵	龵
龶	龶
龷	龷
龸	龸
龹	龹
龺	龺
龻	龻
龼	龼
龽	龽
龾	龾
龿	龿
鿀	鿀
鿁	鿁
鿂	鿂
鿃	鿃
鿄	鿄
鿅	鿅
鿆	鿆
鿇	鿇
鿈	鿈
鿉	鿉
鿊	鿊
鿋	鿋
鿌	鿌
鿍	鿍
鿎	鿎
鿏	鿏
鿐	鿐
鿑	鿑
鿒	鿒
鿓	鿓
鿔	鿔
鿕	鿕
鿖	鿖
鿗	鿗
鿘	鿘
鿙	鿙
鿚	鿚
鿛	鿛
鿜	鿜
鿝	鿝
鿞	鿞
鿟	鿟
鿠	鿠
鿡	鿡
鿢	鿢
鿣	鿣
鿤	鿤
鿥	鿥
鿦	鿦
鿧	鿧
鿨	鿨
鿩	鿩
鿪	鿪
鿫	鿫
鿬	鿬
鿭	鿭
鿮	鿮
鿯	鿯
鿰	鿰
鿱	鿱
鿲	鿲
鿳	鿳
鿴	鿴
鿵	鿵
鿶	鿶
鿷	鿷
鿸	鿸
鿹	鿹
鿺	鿺
鿻	鿻
鿼	鿼
鿽	鿽
鿾	鿾
鿿	鿿
ꀀ	ꀀ
ꀁ	ꀁ
ꀂ	ꀂ
ꀃ	ꀃ
ꀄ	ꀄ
ꀅ	ꀅ
ꀆ	ꀆ
ꀇ	ꀇ
ꀈ	ꀈ
ꀉ	ꀉ
ꀊ	ꀊ
ꀋ	ꀋ
ꀌ	ꀌ
ꀍ	ꀍ
ꀎ	ꀎ
ꀏ	ꀏ
ꀐ	ꀐ
ꀑ	ꀑ
ꀒ	ꀒ
ꀓ	ꀓ
ꀔ	ꀔ
ꀕ	ꀕ
ꀖ	ꀖ
ꀗ	ꀗ
ꀘ	ꀘ
ꀙ	ꀙ
ꀚ	ꀚ
ꀛ	ꀛ
ꀜ	ꀜ
ꀝ	ꀝ
ꀞ	ꀞ
ꀟ	ꀟ
ꀠ	ꀠ
ꀡ	ꀡ
ꀢ	ꀢ
ꀣ	ꀣ
ꀤ	ꀤ
ꀥ	ꀥ
ꀦ	ꀦ
ꀧ	ꀧ
ꀨ	ꀨ
ꀩ	ꀩ
ꀪ	ꀪ
ꀫ	ꀫ
ꀬ	ꀬ
ꀭ	ꀭ
ꀮ	ꀮ
ꀯ	ꀯ
ꀰ	ꀰ
ꀱ	ꀱ
ꀲ	ꀲ
ꀳ	ꀳ
ꀴ	ꀴ
ꀵ	ꀵ
ꀶ	ꀶ
ꀷ	ꀷ
ꀸ	ꀸ
ꀹ	ꀹ
ꀺ	ꀺ
ꀻ	ꀻ
ꀼ	ꀼ
ꀽ	ꀽ
ꀾ	ꀾ
ꀿ	ꀿ
ꁀ	ꁀ
ꁁ	ꁁ
ꁂ	ꁂ
ꁃ	ꁃ
ꁄ	ꁄ
ꁅ	ꁅ
ꁆ	ꁆ
ꁇ	ꁇ
ꁈ	ꁈ
ꁉ	ꁉ
ꁊ	ꁊ
ꁋ	ꁋ
ꁌ	ꁌ
ꁍ	ꁍ
ꁎ	ꁎ
ꁏ	ꁏ
ꁐ	ꁐ
ꁑ	ꁑ
ꁒ	ꁒ
ꁓ	ꁓ
ꁔ	ꁔ
ꁕ	ꁕ
ꁖ	ꁖ
ꁗ	ꁗ
ꁘ	ꁘ
ꁙ	ꁙ
ꁚ	ꁚ
ꁛ	ꁛ
ꁜ	ꁜ
ꁝ	ꁝ
ꁞ	ꁞ
ꁟ	ꁟ
ꁠ	ꁠ
ꁡ	ꁡ
ꁢ	ꁢ
ꁣ	ꁣ
ꁤ	ꁤ
ꁥ	ꁥ
ꁦ	ꁦ
ꁧ	ꁧ
ꁨ	ꁨ
ꁩ	ꁩ
ꁪ	ꁪ
ꁫ	ꁫ
ꁬ	ꁬ
ꁭ	ꁭ
ꁮ	ꁮ
ꁯ	ꁯ
ꁰ	ꁰ
ꁱ	ꁱ
ꁲ	ꁲ
ꁳ	ꁳ
ꁴ	ꁴ
ꁵ	ꁵ
ꁶ	ꁶ
ꁷ	ꁷ
ꁸ	ꁸ
ꁹ	ꁹ
ꁺ	ꁺ
ꁻ	ꁻ
ꁼ	ꁼ
ꁽ	ꁽ
ꁾ	ꁾ
ꁿ	ꁿ
ꂀ	ꂀ
ꂁ	ꂁ
ꂂ	ꂂ
ꂃ	ꂃ
ꂄ	ꂄ
ꂅ	ꂅ
ꂆ	ꂆ
ꂇ	ꂇ
ꂈ	ꂈ
ꂉ	ꂉ
ꂊ	ꂊ
ꂋ	ꂋ
ꂌ	ꂌ
ꂍ	ꂍ
ꂎ	ꂎ
ꂏ	ꂏ
ꂐ	ꂐ
ꂑ	ꂑ
ꂒ	ꂒ
ꂓ	ꂓ
ꂔ	ꂔ
ꂕ	ꂕ
ꂖ	ꂖ
ꂗ	ꂗ
ꂘ	ꂘ
ꂙ	ꂙ
ꂚ	ꂚ
ꂛ	ꂛ
ꂜ	ꂜ
ꂝ	ꂝ
ꂞ	ꂞ
ꂟ	ꂟ
ꂠ	ꂠ
ꂡ	ꂡ
ꂢ	ꂢ
ꂣ	ꂣ
ꂤ	ꂤ
ꂥ	ꂥ
ꂦ	ꂦ
ꂧ	ꂧ
ꂨ	ꂨ
ꂩ	ꂩ
ꂪ	ꂪ
ꂫ	ꂫ
ꂬ	ꂬ
ꂭ	ꂭ
ꂮ	ꂮ
ꂯ	ꂯ
ꂰ	ꂰ
ꂱ	ꂱ
ꂲ	ꂲ
ꂳ	ꂳ
ꂴ	ꂴ
ꂵ	ꂵ
ꂶ	ꂶ
ꂷ	ꂷ
ꂸ	ꂸ
ꂹ	ꂹ
ꂺ	ꂺ
ꂻ	ꂻ
ꂼ	ꂼ
ꂽ	ꂽ
ꂾ	ꂾ
ꂿ	ꂿ
ꃀ	ꃀ
ꃁ	ꃁ
ꃂ	ꃂ
ꃃ	ꃃ
ꃄ	ꃄ
ꃅ	ꃅ
ꃆ	ꃆ
ꃇ	ꃇ
ꃈ	ꃈ
ꃉ	ꃉ
ꃊ	ꃊ
ꃋ	ꃋ
ꃌ	ꃌ
ꃍ	ꃍ
ꃎ	ꃎ
ꃏ	ꃏ
ꃐ	ꃐ
ꃑ	ꃑ
ꃒ	ꃒ
ꃓ	ꃓ
ꃔ	ꃔ
ꃕ	ꃕ
ꃖ	ꃖ
ꃗ	ꃗ
ꃘ	ꃘ
ꃙ	ꃙ
ꃚ	ꃚ
ꃛ	ꃛ
ꃜ	ꃜ
ꃝ	ꃝ
ꃞ	ꃞ
ꃟ	ꃟ
ꃠ	ꃠ
ꃡ	ꃡ
ꃢ	ꃢ
ꃣ	ꃣ
ꃤ	ꃤ
ꃥ	ꃥ
ꃦ	ꃦ
ꃧ	ꃧ
ꃨ	ꃨ
ꃩ	ꃩ
ꃪ	ꃪ
ꃫ	ꃫ
ꃬ	ꃬ
ꃭ	ꃭ
ꃮ	ꃮ
ꃯ	ꃯ
ꃰ	ꃰ
ꃱ	ꃱ
ꃲ	ꃲ
ꃳ	ꃳ
ꃴ	ꃴ
ꃵ	ꃵ
ꃶ	ꃶ
ꃷ	ꃷ
ꃸ	ꃸ
ꃹ	ꃹ
ꃺ	ꃺ
ꃻ	ꃻ
ꃼ	ꃼ
ꃽ	ꃽ
ꃾ	ꃾ
ꃿ	ꃿ
ꄀ	ꄀ
ꄁ	ꄁ
ꄂ	ꄂ
ꄃ	ꄃ
ꄄ	ꄄ
ꄅ	ꄅ
ꄆ	ꄆ
ꄇ	ꄇ
ꄈ	ꄈ
ꄉ	ꄉ
ꄊ	ꄊ
ꄋ	ꄋ
ꄌ	ꄌ
ꄍ	ꄍ
ꄎ	ꄎ
ꄏ	ꄏ
ꄐ	ꄐ
ꄑ	ꄑ
ꄒ	ꄒ
ꄓ	ꄓ
ꄔ	ꄔ
ꄕ	ꄕ
ꄖ	ꄖ
ꄗ	ꄗ
ꄘ	ꄘ
ꄙ	ꄙ
ꄚ	ꄚ
ꄛ	ꄛ
ꄜ	ꄜ
ꄝ	ꄝ
ꄞ	ꄞ
ꄟ	ꄟ
ꄠ	ꄠ
ꄡ	ꄡ
ꄢ	ꄢ
ꄣ	ꄣ
ꄤ	ꄤ
ꄥ	ꄥ
ꄦ	ꄦ
ꄧ	ꄧ
ꄨ	ꄨ
ꄩ	ꄩ
ꄪ	ꄪ
ꄫ	ꄫ
ꄬ	ꄬ
ꄭ	ꄭ
ꄮ	ꄮ
ꄯ	ꄯ
ꄰ	ꄰ
ꄱ	ꄱ
ꄲ	ꄲ
ꄳ	ꄳ
ꄴ	ꄴ
ꄵ	ꄵ
ꄶ	ꄶ
ꄷ	ꄷ
ꄸ	ꄸ
ꄹ	ꄹ
ꄺ	ꄺ
ꄻ	ꄻ
ꄼ	ꄼ
ꄽ	ꄽ
ꄾ	ꄾ
ꄿ	ꄿ
ꅀ	ꅀ
ꅁ	ꅁ
ꅂ	ꅂ
ꅃ	ꅃ
ꅄ	ꅄ
ꅅ	ꅅ
ꅆ	ꅆ
ꅇ	ꅇ
ꅈ	ꅈ
ꅉ	ꅉ
ꅊ	ꅊ
ꅋ	ꅋ
ꅌ	ꅌ
ꅍ	ꅍ
ꅎ	ꅎ
ꅏ	ꅏ
ꅐ	ꅐ
ꅑ	ꅑ
ꅒ	ꅒ
ꅓ	ꅓ
ꅔ	ꅔ
ꅕ	ꅕ
ꅖ	ꅖ
ꅗ	ꅗ
ꅘ	ꅘ
ꅙ	ꅙ
ꅚ	ꅚ
ꅛ	ꅛ
ꅜ	ꅜ
ꅝ	ꅝ
ꅞ	ꅞ
ꅟ	ꅟ
ꅠ	ꅠ
ꅡ	ꅡ
ꅢ	ꅢ
ꅣ	ꅣ
ꅤ	ꅤ
ꅥ	ꅥ
ꅦ	ꅦ
ꅧ	ꅧ
ꅨ	ꅨ
ꅩ	ꅩ
ꅪ	ꅪ
ꅫ	ꅫ
ꅬ	ꅬ
ꅭ	ꅭ
ꅮ	ꅮ
ꅯ	ꅯ
ꅰ	ꅰ
ꅱ	ꅱ
ꅲ	ꅲ
ꅳ	ꅳ
ꅴ	ꅴ
ꅵ	ꅵ
ꅶ	ꅶ
ꅷ	ꅷ
ꅸ	ꅸ
ꅹ	ꅹ
ꅺ	ꅺ
ꅻ	ꅻ
ꅼ	ꅼ
ꅽ	ꅽ
ꅾ	ꅾ
ꅿ	ꅿ
ꆀ	ꆀ
ꆁ	ꆁ
ꆂ	ꆂ
ꆃ	ꆃ
ꆄ	ꆄ
ꆅ	ꆅ
ꆆ	ꆆ
ꆇ	ꆇ
ꆈ	ꆈ
ꆉ	ꆉ
ꆊ	ꆊ
ꆋ	ꆋ
ꆌ	ꆌ
ꆍ	ꆍ
ꆎ	ꆎ
ꆏ	ꆏ
ꆐ	ꆐ
ꆑ	ꆑ
ꆒ	ꆒ
ꆓ	ꆓ
ꆔ	ꆔ
ꆕ	ꆕ
ꆖ	ꆖ
ꆗ	ꆗ
ꆘ	ꆘ
ꆙ	ꆙ
ꆚ	ꆚ
ꆛ	ꆛ
ꆜ	ꆜ
ꆝ	ꆝ
ꆞ	ꆞ
ꆟ	ꆟ
ꆠ	ꆠ
ꆡ	ꆡ
ꆢ	ꆢ
ꆣ	ꆣ
ꆤ	ꆤ
ꆥ	ꆥ
ꆦ	ꆦ
ꆧ	ꆧ
ꆨ	ꆨ
ꆩ	ꆩ
ꆪ	ꆪ
ꆫ	ꆫ
ꆬ	ꆬ
ꆭ	ꆭ
ꆮ	ꆮ
ꆯ	ꆯ
ꆰ	ꆰ
ꆱ	ꆱ
ꆲ	ꆲ
ꆳ	ꆳ
ꆴ	ꆴ
ꆵ	ꆵ
ꆶ	ꆶ
ꆷ	ꆷ
ꆸ	ꆸ
ꆹ	ꆹ
ꆺ	ꆺ
ꆻ	ꆻ
ꆼ	ꆼ
ꆽ	ꆽ
ꆾ	ꆾ
ꆿ	ꆿ
ꇀ	ꇀ
ꇁ	ꇁ
ꇂ	ꇂ
ꇃ	ꇃ
ꇄ	ꇄ
ꇅ	ꇅ
ꇆ	ꇆ
ꇇ	ꇇ
ꇈ	ꇈ
ꇉ	ꇉ
ꇊ	ꇊ
ꇋ	ꇋ
ꇌ	ꇌ
ꇍ	ꇍ
ꇎ	ꇎ
ꇏ	ꇏ
ꇐ	ꇐ
ꇑ	ꇑ
ꇒ	ꇒ
ꇓ	ꇓ
ꇔ	ꇔ
ꇕ	ꇕ
ꇖ	ꇖ
ꇗ	ꇗ
ꇘ	ꇘ
ꇙ	ꇙ
ꇚ	ꇚ
ꇛ	ꇛ
ꇜ	ꇜ
ꇝ	ꇝ
ꇞ	ꇞ
ꇟ	ꇟ
ꇠ	ꇠ
ꇡ	ꇡ
ꇢ	ꇢ
ꇣ	ꇣ
ꇤ	ꇤ
ꇥ	ꇥ
ꇦ	ꇦ
ꇧ	ꇧ
ꇨ	ꇨ
ꇩ	ꇩ
ꇪ	ꇪ
ꇫ	ꇫ
ꇬ	ꇬ
ꇭ	ꇭ
ꇮ	ꇮ
ꇯ	ꇯ
ꇰ	ꇰ
ꇱ	ꇱ
ꇲ	ꇲ
ꇳ	ꇳ
ꇴ	ꇴ
ꇵ	ꇵ
ꇶ	ꇶ
ꇷ	ꇷ
ꇸ	ꇸ
ꇹ	ꇹ
ꇺ	ꇺ
ꇻ	ꇻ
ꇼ	ꇼ
ꇽ	ꇽ
ꇾ	ꇾ
ꇿ	ꇿ
ꈀ	ꈀ
ꈁ	ꈁ
ꈂ	ꈂ
ꈃ	ꈃ
ꈄ	ꈄ
ꈅ	ꈅ
ꈆ	ꈆ
ꈇ	ꈇ
ꈈ	ꈈ
ꈉ	ꈉ
ꈊ	ꈊ
ꈋ	ꈋ
ꈌ	ꈌ
ꈍ	ꈍ
ꈎ	ꈎ
ꈏ	ꈏ
ꈐ	ꈐ
ꈑ	ꈑ
ꈒ	ꈒ
ꈓ	ꈓ
ꈔ	ꈔ
ꈕ	ꈕ
ꈖ	ꈖ
ꈗ	ꈗ
ꈘ	ꈘ
ꈙ	ꈙ
ꈚ	ꈚ
ꈛ	ꈛ
ꈜ	ꈜ
ꈝ	ꈝ
ꈞ	ꈞ
ꈟ	ꈟ
ꈠ	ꈠ
ꈡ	ꈡ
ꈢ	ꈢ
ꈣ	ꈣ
ꈤ	ꈤ
ꈥ	ꈥ
ꈦ	ꈦ
ꈧ	ꈧ
ꈨ	ꈨ
ꈩ	ꈩ
ꈪ	ꈪ
ꈫ	ꈫ
ꈬ	ꈬ
ꈭ	ꈭ
ꈮ	ꈮ
ꈯ	ꈯ
ꈰ	ꈰ
ꈱ	ꈱ
ꈲ	ꈲ
ꈳ	ꈳ
ꈴ	ꈴ
ꈵ	ꈵ
ꈶ	ꈶ
ꈷ	ꈷ
ꈸ	ꈸ
ꈹ	ꈹ
ꈺ	ꈺ
ꈻ	ꈻ
ꈼ	ꈼ
ꈽ	ꈽ
ꈾ	ꈾ
ꈿ	ꈿ
ꉀ	ꉀ
ꉁ	ꉁ
ꉂ	ꉂ
ꉃ	ꉃ
ꉄ	ꉄ
ꉅ	ꉅ
ꉆ	ꉆ
ꉇ	ꉇ
ꉈ	ꉈ
ꉉ	ꉉ
ꉊ	ꉊ
ꉋ	ꉋ
ꉌ	ꉌ
ꉍ	ꉍ
ꉎ	ꉎ
ꉏ	ꉏ
ꉐ	ꉐ
ꉑ	ꉑ
ꉒ	ꉒ
ꉓ	ꉓ
ꉔ	ꉔ
ꉕ	ꉕ
ꉖ	ꉖ
ꉗ	ꉗ
ꉘ	ꉘ
ꉙ	ꉙ
ꉚ	ꉚ
ꉛ	ꉛ
ꉜ	ꉜ
ꉝ	ꉝ
ꉞ	ꉞ
ꉟ	ꉟ
ꉠ	ꉠ
ꉡ	ꉡ
ꉢ	ꉢ
ꉣ	ꉣ
ꉤ	ꉤ
ꉥ	ꉥ
ꉦ	ꉦ
ꉧ	ꉧ
ꉨ	ꉨ
ꉩ	ꉩ
ꉪ	ꉪ
ꉫ	ꉫ
ꉬ	ꉬ
ꉭ	ꉭ
ꉮ	ꉮ
ꉯ	ꉯ
ꉰ	ꉰ
ꉱ	ꉱ
ꉲ	ꉲ
ꉳ	ꉳ
ꉴ	ꉴ
ꉵ	ꉵ
ꉶ	ꉶ
ꉷ	ꉷ
ꉸ	ꉸ
ꉹ	ꉹ
ꉺ	ꉺ
ꉻ	ꉻ
ꉼ	ꉼ
ꉽ	ꉽ
ꉾ	ꉾ
ꉿ	ꉿ
ꊀ	ꊀ
ꊁ	ꊁ
ꊂ	ꊂ
ꊃ	ꊃ
ꊄ	ꊄ
ꊅ	ꊅ
ꊆ	ꊆ
ꊇ	ꊇ
ꊈ	ꊈ
ꊉ	ꊉ
ꊊ	ꊊ
ꊋ	ꊋ
ꊌ	ꊌ
ꊍ	ꊍ
ꊎ	ꊎ
ꊏ	ꊏ
ꊐ	ꊐ
ꊑ	ꊑ
ꊒ	ꊒ
ꊓ	ꊓ
ꊔ	ꊔ
ꊕ	ꊕ
ꊖ	ꊖ
ꊗ	ꊗ
ꊘ	ꊘ
ꊙ	ꊙ
ꊚ	ꊚ
ꊛ	ꊛ
ꊜ	ꊜ
ꊝ	ꊝ
ꊞ	ꊞ
ꊟ	ꊟ
ꊠ	ꊠ
ꊡ	ꊡ
ꊢ	ꊢ
ꊣ	ꊣ
ꊤ	ꊤ
ꊥ	ꊥ
ꊦ	ꊦ
ꊧ	ꊧ
ꊨ	ꊨ
ꊩ	ꊩ
ꊪ	ꊪ
ꊫ	ꊫ
ꊬ	ꊬ
ꊭ	ꊭ
ꊮ	ꊮ
ꊯ	ꊯ
ꊰ	ꊰ
ꊱ	ꊱ
ꊲ	ꊲ
ꊳ	ꊳ
ꊴ	ꊴ
ꊵ	ꊵ
ꊶ	ꊶ
ꊷ	ꊷ
ꊸ	ꊸ
ꊹ	ꊹ
ꊺ	ꊺ
ꊻ	ꊻ
ꊼ	ꊼ
ꊽ	ꊽ
ꊾ	ꊾ
ꊿ	ꊿ
ꋀ	ꋀ
ꋁ	ꋁ
ꋂ	ꋂ
ꋃ	ꋃ
ꋄ	ꋄ
ꋅ	ꋅ
ꋆ	ꋆ
ꋇ	ꋇ
ꋈ	ꋈ
ꋉ	ꋉ
ꋊ	ꋊ
ꋋ	ꋋ
ꋌ	ꋌ
ꋍ	ꋍ
ꋎ	ꋎ
ꋏ	ꋏ
ꋐ	ꋐ
ꋑ	ꋑ
ꋒ	ꋒ
ꋓ	ꋓ
ꋔ	ꋔ
ꋕ	ꋕ
ꋖ	ꋖ
ꋗ	ꋗ
ꋘ	ꋘ
ꋙ	ꋙ
ꋚ	ꋚ
ꋛ	ꋛ
ꋜ	ꋜ
ꋝ	ꋝ
ꋞ	ꋞ
ꋟ	ꋟ
ꋠ	ꋠ
ꋡ	ꋡ
ꋢ	ꋢ
ꋣ	ꋣ
ꋤ	ꋤ
ꋥ	ꋥ
ꋦ	ꋦ
ꋧ	ꋧ
ꋨ	ꋨ
ꋩ	ꋩ
ꋪ	ꋪ
ꋫ	ꋫ
ꋬ	ꋬ
ꋭ	ꋭ
ꋮ	ꋮ
ꋯ	ꋯ
ꋰ	ꋰ
ꋱ	ꋱ
ꋲ	ꋲ
ꋳ	ꋳ
ꋴ	ꋴ
ꋵ	ꋵ
ꋶ	ꋶ
ꋷ	ꋷ
ꋸ	ꋸ
ꋹ	ꋹ
ꋺ	ꋺ
ꋻ	ꋻ
ꋼ	ꋼ
ꋽ	ꋽ
ꋾ	ꋾ
ꋿ	ꋿ
ꌀ	ꌀ
ꌁ	ꌁ
ꌂ	ꌂ
ꌃ	ꌃ
ꌄ	ꌄ
ꌅ	ꌅ
ꌆ	ꌆ
ꌇ	ꌇ
ꌈ	ꌈ
ꌉ	ꌉ
ꌊ	ꌊ
ꌋ	ꌋ
ꌌ	ꌌ
ꌍ	ꌍ
ꌎ	ꌎ
ꌏ	ꌏ
ꌐ	ꌐ
ꌑ	ꌑ
ꌒ	ꌒ
ꌓ	ꌓ
ꌔ	ꌔ
ꌕ	ꌕ
ꌖ	ꌖ
ꌗ	ꌗ
ꌘ	ꌘ
ꌙ	ꌙ
ꌚ	ꌚ
ꌛ	ꌛ
ꌜ	ꌜ
ꌝ	ꌝ
ꌞ	ꌞ
ꌟ	ꌟ
ꌠ	ꌠ
ꌡ	ꌡ
ꌢ	ꌢ
ꌣ	ꌣ
ꌤ	ꌤ
ꌥ	ꌥ
ꌦ	ꌦ
ꌧ	ꌧ
ꌨ	ꌨ
ꌩ	ꌩ
ꌪ	ꌪ
ꌫ	ꌫ
ꌬ	ꌬ
ꌭ	ꌭ
ꌮ	ꌮ
ꌯ	ꌯ
ꌰ	ꌰ
ꌱ	ꌱ
ꌲ	ꌲ
ꌳ	ꌳ
ꌴ	ꌴ
ꌵ	ꌵ
ꌶ	ꌶ
ꌷ	ꌷ
ꌸ	ꌸ
ꌹ	ꌹ
ꌺ	ꌺ
ꌻ	ꌻ
ꌼ	ꌼ
ꌽ	ꌽ
ꌾ	ꌾ
ꌿ	ꌿ
ꍀ	ꍀ
ꍁ	ꍁ
ꍂ	ꍂ
ꍃ	ꍃ
ꍄ	ꍄ
ꍅ	ꍅ
ꍆ	ꍆ
ꍇ	ꍇ
ꍈ	ꍈ
ꍉ	ꍉ
ꍊ	ꍊ
ꍋ	ꍋ
ꍌ	ꍌ
ꍍ	ꍍ
ꍎ	ꍎ
ꍏ	ꍏ
ꍐ	ꍐ
ꍑ	ꍑ
ꍒ	ꍒ
ꍓ	ꍓ
ꍔ	ꍔ
ꍕ	ꍕ
ꍖ	ꍖ
ꍗ	ꍗ
ꍘ	ꍘ
ꍙ	ꍙ
ꍚ	ꍚ
ꍛ	ꍛ
ꍜ	ꍜ
ꍝ	ꍝ
ꍞ	ꍞ
ꍟ	ꍟ
ꍠ	ꍠ
ꍡ	ꍡ
ꍢ	ꍢ
ꍣ	ꍣ
ꍤ	ꍤ
ꍥ	ꍥ
ꍦ	ꍦ
ꍧ	ꍧ
ꍨ	ꍨ
ꍩ	ꍩ
ꍪ	ꍪ
ꍫ	ꍫ
ꍬ	ꍬ
ꍭ	ꍭ
ꍮ	ꍮ
ꍯ	ꍯ
ꍰ	ꍰ
ꍱ	ꍱ
ꍲ	ꍲ
ꍳ	ꍳ
ꍴ	ꍴ
ꍵ	ꍵ
ꍶ	ꍶ
ꍷ	ꍷ
ꍸ	ꍸ
ꍹ	ꍹ
ꍺ	ꍺ
ꍻ	ꍻ
ꍼ	ꍼ
ꍽ	ꍽ
ꍾ	ꍾ
ꍿ	ꍿ
ꎀ	ꎀ
ꎁ	ꎁ
ꎂ	ꎂ
ꎃ	ꎃ
ꎄ	ꎄ
ꎅ	ꎅ
ꎆ	ꎆ
ꎇ	ꎇ
ꎈ	ꎈ
ꎉ	ꎉ
ꎊ	ꎊ
ꎋ	ꎋ
ꎌ	ꎌ
ꎍ	ꎍ
ꎎ	ꎎ
ꎏ	ꎏ
ꎐ	ꎐ
ꎑ	ꎑ
ꎒ	ꎒ
ꎓ	ꎓ
ꎔ	ꎔ
ꎕ	ꎕ
ꎖ	ꎖ
ꎗ	ꎗ
ꎘ	ꎘ
ꎙ	ꎙ
ꎚ	ꎚ
ꎛ	ꎛ
ꎜ	ꎜ
ꎝ	ꎝ
ꎞ	ꎞ
ꎟ	ꎟ
ꎠ	ꎠ
ꎡ	ꎡ
ꎢ	ꎢ
ꎣ	ꎣ
ꎤ	ꎤ
ꎥ	ꎥ
ꎦ	ꎦ
ꎧ	ꎧ
ꎨ	ꎨ
ꎩ	ꎩ
ꎪ	ꎪ
ꎫ	ꎫ
ꎬ	ꎬ
ꎭ	ꎭ
ꎮ	ꎮ
ꎯ	ꎯ
ꎰ	ꎰ
ꎱ	ꎱ
ꎲ	ꎲ
ꎳ	ꎳ
ꎴ	ꎴ
ꎵ	ꎵ
ꎶ	ꎶ
ꎷ	ꎷ
ꎸ	ꎸ
ꎹ	ꎹ
ꎺ	ꎺ
ꎻ	ꎻ
ꎼ	ꎼ
ꎽ	ꎽ
ꎾ	ꎾ
ꎿ	ꎿ
ꏀ	ꏀ
ꏁ	ꏁ
ꏂ	ꏂ
ꏃ	ꏃ
ꏄ	ꏄ
ꏅ	ꏅ
ꏆ	ꏆ
ꏇ	ꏇ
ꏈ	ꏈ
ꏉ	ꏉ
ꏊ	ꏊ
ꏋ	ꏋ
ꏌ	ꏌ
ꏍ	ꏍ
ꏎ	ꏎ
ꏏ	ꏏ
ꏐ	ꏐ
ꏑ	ꏑ
ꏒ	ꏒ
ꏓ	ꏓ
ꏔ	ꏔ
ꏕ	ꏕ
ꏖ	ꏖ
ꏗ	ꏗ
ꏘ	ꏘ
ꏙ	ꏙ
ꏚ	ꏚ
ꏛ	ꏛ
ꏜ	ꏜ
ꏝ	ꏝ
ꏞ	ꏞ
ꏟ	ꏟ
ꏠ	ꏠ
ꏡ	ꏡ
ꏢ	ꏢ
ꏣ	ꏣ
ꏤ	ꏤ
ꏥ	ꏥ
ꏦ	ꏦ
ꏧ	ꏧ
ꏨ	ꏨ
ꏩ	ꏩ
ꏪ	ꏪ
ꏫ	ꏫ
ꏬ	ꏬ
ꏭ	ꏭ
ꏮ	ꏮ
ꏯ	ꏯ
ꏰ	ꏰ
ꏱ	ꏱ
ꏲ	ꏲ
ꏳ	ꏳ
ꏴ	ꏴ
ꏵ	ꏵ
ꏶ	ꏶ
ꏷ	ꏷ
ꏸ	ꏸ
ꏹ	ꏹ
ꏺ	ꏺ
ꏻ	ꏻ
ꏼ	ꏼ
ꏽ	ꏽ
ꏾ	ꏾ
ꏿ	ꏿ
ꐀ	ꐀ
ꐁ	ꐁ
ꐂ	ꐂ
ꐃ	ꐃ
ꐄ	ꐄ
ꐅ	ꐅ
ꐆ	ꐆ
ꐇ	ꐇ
ꐈ	ꐈ
ꐉ	ꐉ
ꐊ	ꐊ
ꐋ	ꐋ
ꐌ	ꐌ
ꐍ	ꐍ
ꐎ	ꐎ
ꐏ	ꐏ
ꐐ	ꐐ
ꐑ	ꐑ
ꐒ	ꐒ
ꐓ	ꐓ
ꐔ	ꐔ
ꐕ	ꐕ
ꐖ	ꐖ
ꐗ	ꐗ
ꐘ	ꐘ
ꐙ	ꐙ
ꐚ	ꐚ
ꐛ	ꐛ
ꐜ	ꐜ
ꐝ	ꐝ
ꐞ	ꐞ
ꐟ	ꐟ
ꐠ	ꐠ
ꐡ	ꐡ
ꐢ	ꐢ
ꐣ	ꐣ
ꐤ	ꐤ
ꐥ	ꐥ
ꐦ	ꐦ
ꐧ	ꐧ
ꐨ	ꐨ
ꐩ	ꐩ
ꐪ	ꐪ
ꐫ	ꐫ
ꐬ	ꐬ
ꐭ	ꐭ
ꐮ	ꐮ
ꐯ	ꐯ
ꐰ	ꐰ
ꐱ	ꐱ
ꐲ	ꐲ
ꐳ	ꐳ
ꐴ	ꐴ
ꐵ	ꐵ
ꐶ	ꐶ
ꐷ	ꐷ
ꐸ	ꐸ
ꐹ	ꐹ
ꐺ	ꐺ
ꐻ	ꐻ
ꐼ	ꐼ
ꐽ	ꐽ
ꐾ	ꐾ
ꐿ	ꐿ
ꑀ	ꑀ
ꑁ	ꑁ
ꑂ	ꑂ
ꑃ	ꑃ
ꑄ	ꑄ
ꑅ	ꑅ
ꑆ	ꑆ
ꑇ	ꑇ
ꑈ	ꑈ
ꑉ	ꑉ
ꑊ	ꑊ
ꑋ	ꑋ
ꑌ	ꑌ
ꑍ	ꑍ
ꑎ	ꑎ
ꑏ	ꑏ
ꑐ	ꑐ
ꑑ	ꑑ
ꑒ	ꑒ
ꑓ	ꑓ
ꑔ	ꑔ
ꑕ	ꑕ
ꑖ	ꑖ
ꑗ	ꑗ
ꑘ	ꑘ
ꑙ	ꑙ
ꑚ	ꑚ
ꑛ	ꑛ
ꑜ	ꑜ
ꑝ	ꑝ
ꑞ	ꑞ
ꑟ	ꑟ
ꑠ	ꑠ
ꑡ	ꑡ
ꑢ	ꑢ
ꑣ	ꑣ
ꑤ	ꑤ
ꑥ	ꑥ
ꑦ	ꑦ
ꑧ	ꑧ
ꑨ	ꑨ
ꑩ	ꑩ
ꑪ	ꑪ
ꑫ	ꑫ
ꑬ	ꑬ
ꑭ	ꑭ
ꑮ	ꑮ
ꑯ	ꑯ
ꑰ	ꑰ
ꑱ	ꑱ
ꑲ	ꑲ
ꑳ	ꑳ
ꑴ	ꑴ
ꑵ	ꑵ
ꑶ	ꑶ
ꑷ	ꑷ
ꑸ	ꑸ
ꑹ	ꑹ
ꑺ	ꑺ
ꑻ	ꑻ
ꑼ	ꑼ
ꑽ	ꑽ
ꑾ	ꑾ
ꑿ	ꑿ
ꒀ	ꒀ
ꒁ	ꒁ
ꒂ	ꒂ
ꒃ	ꒃ
ꒄ	ꒄ
ꒅ	ꒅ
ꒆ	ꒆ
ꒇ	ꒇ
ꒈ	ꒈ
ꒉ	ꒉ
ꒊ	ꒊ
ꒋ	ꒋ
ꒌ	ꒌ
꒍	꒍
꒎	꒎
꒏	꒏
꒐	꒐
꒑	꒑
꒒	꒒
꒓	꒓
꒔	꒔
꒕	꒕
꒖	꒖
꒗	꒗
꒘	꒘
꒙	꒙
꒚	꒚
꒛	꒛
꒜	꒜
꒝	꒝
꒞	꒞
꒟	꒟
꒠	꒠
꒡	꒡
꒢	꒢
꒣	꒣
꒤	꒤
꒥	꒥
꒦	꒦
꒧	꒧
꒨	꒨
꒩	꒩
꒪	꒪
꒫	꒫
꒬	꒬
꒭	꒭
꒮	꒮
꒯	꒯
꒰	꒰
꒱	꒱
꒲	꒲
꒳	꒳
꒴	꒴
꒵	꒵
꒶	꒶
꒷	꒷
꒸	꒸
꒹	꒹
꒺	꒺
꒻	꒻
꒼	꒼
꒽	꒽
꒾	꒾
꒿	꒿
꓀	꓀
꓁	꓁
꓂	꓂
꓃	꓃
꓄	꓄
꓅	꓅
꓆	꓆
꓇	꓇
꓈	꓈
꓉	꓉
꓊	꓊
꓋	꓋
꓌	꓌
꓍	꓍
꓎	꓎
꓏	꓏
ꓐ	ꓐ
ꓑ	ꓑ
ꓒ	ꓒ
ꓓ	ꓓ
ꓔ	ꓔ
ꓕ	ꓕ
ꓖ	ꓖ
ꓗ	ꓗ
ꓘ	ꓘ
ꓙ	ꓙ
ꓚ	ꓚ
ꓛ	ꓛ
ꓜ	ꓜ
ꓝ	ꓝ
ꓞ	ꓞ
ꓟ	ꓟ
ꓠ	ꓠ
ꓡ	ꓡ
ꓢ	ꓢ
ꓣ	ꓣ
ꓤ	ꓤ
ꓥ	ꓥ
ꓦ	ꓦ
ꓧ	ꓧ
ꓨ	ꓨ
ꓩ	ꓩ
ꓪ	ꓪ
ꓫ	ꓫ
ꓬ	ꓬ
ꓭ	ꓭ
ꓮ	ꓮ
ꓯ	ꓯ
ꓰ	ꓰ
ꓱ	ꓱ
ꓲ	ꓲ
ꓳ	ꓳ
ꓴ	ꓴ
ꓵ	ꓵ
ꓶ	ꓶ
ꓷ	ꓷ
ꓸ	ꓸ
ꓹ	ꓹ
ꓺ	ꓺ
ꓻ	ꓻ
ꓼ	ꓼ
ꓽ	ꓽ
꓾	꓾
꓿	꓿
ꔀ	ꔀ
ꔁ	ꔁ
ꔂ	ꔂ
ꔃ	ꔃ
ꔄ	ꔄ
ꔅ	ꔅ
ꔆ	ꔆ
ꔇ	ꔇ
ꔈ	ꔈ
ꔉ	ꔉ
ꔊ	ꔊ
ꔋ	ꔋ
ꔌ	ꔌ
ꔍ	ꔍ
ꔎ	ꔎ
ꔏ	ꔏ
ꔐ	ꔐ
ꔑ	ꔑ
ꔒ	ꔒ
ꔓ	ꔓ
ꔔ	ꔔ
ꔕ	ꔕ
ꔖ	ꔖ
ꔗ	ꔗ
ꔘ	ꔘ
ꔙ	ꔙ
ꔚ	ꔚ
ꔛ	ꔛ
ꔜ	ꔜ
ꔝ	ꔝ
ꔞ	ꔞ
ꔟ	ꔟ
ꔠ	ꔠ
ꔡ	ꔡ
ꔢ	ꔢ
ꔣ	ꔣ
ꔤ	ꔤ
ꔥ	ꔥ
ꔦ	ꔦ
ꔧ	ꔧ
ꔨ	ꔨ
ꔩ	ꔩ
ꔪ	ꔪ
ꔫ	ꔫ
ꔬ	ꔬ
ꔭ	ꔭ
ꔮ	ꔮ
ꔯ	ꔯ
ꔰ	ꔰ
ꔱ	ꔱ
ꔲ	ꔲ
ꔳ	ꔳ
ꔴ	ꔴ
ꔵ	ꔵ
ꔶ	ꔶ
ꔷ	ꔷ
ꔸ	ꔸ
ꔹ	ꔹ
ꔺ	ꔺ
ꔻ	ꔻ
ꔼ	ꔼ
ꔽ	ꔽ
ꔾ	ꔾ
ꔿ	ꔿ
ꕀ	ꕀ
ꕁ	ꕁ
ꕂ	ꕂ
ꕃ	ꕃ
ꕄ	ꕄ
ꕅ	ꕅ
ꕆ	ꕆ
ꕇ	ꕇ
ꕈ	ꕈ
ꕉ	ꕉ
ꕊ	ꕊ
ꕋ	ꕋ
ꕌ	ꕌ
ꕍ	ꕍ
ꕎ	ꕎ
ꕏ	ꕏ
ꕐ	ꕐ
ꕑ	ꕑ
ꕒ	ꕒ
ꕓ	ꕓ
ꕔ	ꕔ
ꕕ	ꕕ
ꕖ	ꕖ
ꕗ	ꕗ
ꕘ	ꕘ
ꕙ	ꕙ
ꕚ	ꕚ
ꕛ	ꕛ
ꕜ	ꕜ
ꕝ	ꕝ
ꕞ	ꕞ
ꕟ	ꕟ
ꕠ	ꕠ
ꕡ	ꕡ
ꕢ	ꕢ
ꕣ	ꕣ
ꕤ	ꕤ
ꕥ	ꕥ
ꕦ	ꕦ
ꕧ	ꕧ
ꕨ	ꕨ
ꕩ	ꕩ
ꕪ	ꕪ
ꕫ	ꕫ
ꕬ	ꕬ
ꕭ	ꕭ
ꕮ	ꕮ
ꕯ	ꕯ
ꕰ	ꕰ
ꕱ	ꕱ
ꕲ	ꕲ
ꕳ	ꕳ
ꕴ	ꕴ
ꕵ	ꕵ
ꕶ	ꕶ
ꕷ	ꕷ
ꕸ	ꕸ
ꕹ	ꕹ
ꕺ	ꕺ
ꕻ	ꕻ
ꕼ	ꕼ
ꕽ	ꕽ
ꕾ	ꕾ
ꕿ	ꕿ
ꖀ	ꖀ
ꖁ	ꖁ
ꖂ	ꖂ
ꖃ	ꖃ
ꖄ	ꖄ
ꖅ	ꖅ
ꖆ	ꖆ
ꖇ	ꖇ
ꖈ	ꖈ
ꖉ	ꖉ
ꖊ	ꖊ
ꖋ	ꖋ
ꖌ	ꖌ
ꖍ	ꖍ
ꖎ	ꖎ
ꖏ	ꖏ
ꖐ	ꖐ
ꖑ	ꖑ
ꖒ	ꖒ
ꖓ	ꖓ
ꖔ	ꖔ
ꖕ	ꖕ
ꖖ	ꖖ
ꖗ	ꖗ
ꖘ	ꖘ
ꖙ	ꖙ
ꖚ	ꖚ
ꖛ	ꖛ
ꖜ	ꖜ
ꖝ	ꖝ
ꖞ	ꖞ
ꖟ	ꖟ
ꖠ	ꖠ
ꖡ	ꖡ
ꖢ	ꖢ
ꖣ	ꖣ
ꖤ	ꖤ
ꖥ	ꖥ
ꖦ	ꖦ
ꖧ	ꖧ
ꖨ	ꖨ
ꖩ	ꖩ
ꖪ	ꖪ
ꖫ	ꖫ
ꖬ	ꖬ
ꖭ	ꖭ
ꖮ	ꖮ
ꖯ	ꖯ
ꖰ	ꖰ
ꖱ	ꖱ
ꖲ	ꖲ
ꖳ	ꖳ
ꖴ	ꖴ
ꖵ	ꖵ
ꖶ	ꖶ
ꖷ	ꖷ
ꖸ	ꖸ
ꖹ	ꖹ
ꖺ	ꖺ
ꖻ	ꖻ
ꖼ	ꖼ
ꖽ	ꖽ
ꖾ	ꖾ
ꖿ	ꖿ
ꗀ	ꗀ
ꗁ	ꗁ
ꗂ	ꗂ
ꗃ	ꗃ
ꗄ	ꗄ
ꗅ	ꗅ
ꗆ	ꗆ
ꗇ	ꗇ
ꗈ	ꗈ
ꗉ	ꗉ
ꗊ	ꗊ
ꗋ	ꗋ
ꗌ	ꗌ
ꗍ	ꗍ
ꗎ	ꗎ
ꗏ	ꗏ
ꗐ	ꗐ
ꗑ	ꗑ
ꗒ	ꗒ
ꗓ	ꗓ
ꗔ	ꗔ
ꗕ	ꗕ
ꗖ	ꗖ
ꗗ	ꗗ
ꗘ	ꗘ
ꗙ	ꗙ
ꗚ	ꗚ
ꗛ	ꗛ
ꗜ	ꗜ
ꗝ	ꗝ
ꗞ	ꗞ
ꗟ	ꗟ
ꗠ	ꗠ
ꗡ	ꗡ
ꗢ	ꗢ
ꗣ	ꗣ
ꗤ	ꗤ
ꗥ	ꗥ
ꗦ	ꗦ
ꗧ	ꗧ
ꗨ	ꗨ
ꗩ	ꗩ
ꗪ	ꗪ
ꗫ	ꗫ
ꗬ	ꗬ
ꗭ	ꗭ
ꗮ	ꗮ
ꗯ	ꗯ
ꗰ	ꗰ
ꗱ	ꗱ
ꗲ	ꗲ
ꗳ	ꗳ
ꗴ	ꗴ
ꗵ	ꗵ
ꗶ	ꗶ
ꗷ	ꗷ
ꗸ	ꗸ
ꗹ	ꗹ
ꗺ	ꗺ
ꗻ	ꗻ
ꗼ	ꗼ
ꗽ	ꗽ
ꗾ	ꗾ
ꗿ	ꗿ
ꘀ	ꘀ
ꘁ	ꘁ
ꘂ	ꘂ
ꘃ	ꘃ
ꘄ	ꘄ
ꘅ	ꘅ
ꘆ	ꘆ
ꘇ	ꘇ
ꘈ	ꘈ
ꘉ	ꘉ
ꘊ	ꘊ
ꘋ	ꘋ
ꘌ	ꘌ
꘍	꘍
꘎	꘎
꘏	꘏
ꘐ	ꘐ
ꘑ	ꘑ
ꘒ	ꘒ
ꘓ	ꘓ
ꘔ	ꘔ
ꘕ	ꘕ
ꘖ	ꘖ
ꘗ	ꘗ
ꘘ	ꘘ
ꘙ	ꘙ
ꘚ	ꘚ
ꘛ	ꘛ
ꘜ	ꘜ
ꘝ	ꘝ
ꘞ	ꘞ
ꘟ	ꘟ
꘠	꘠
꘡	꘡
꘢	꘢
꘣	꘣
꘤	꘤
꘥	꘥
꘦	꘦
꘧	꘧
꘨	꘨
꘩	꘩
ꘪ	ꘪ
ꘫ	ꘫ
꘬	꘬
꘭	꘭
꘮	꘮
꘯	꘯
꘰	꘰
꘱	꘱
꘲	꘲
꘳	꘳
꘴	꘴
꘵	꘵
꘶	꘶
꘷	꘷
꘸	꘸
꘹	꘹
꘺	꘺
꘻	꘻
꘼	꘼
꘽	꘽
꘾	꘾
꘿	꘿
Ꙁ	Ꙁ
ꙁ	ꙁ
Ꙃ	Ꙃ
ꙃ	ꙃ
Ꙅ	Ꙅ
ꙅ	ꙅ
Ꙇ	Ꙇ
ꙇ	ꙇ
Ꙉ	Ꙉ
ꙉ	ꙉ
Ꙋ	Ꙋ
ꙋ	ꙋ
Ꙍ	Ꙍ
ꙍ	ꙍ
Ꙏ	Ꙏ
ꙏ	ꙏ
Ꙑ	Ꙑ
ꙑ	ꙑ
Ꙓ	Ꙓ
ꙓ	ꙓ
Ꙕ	Ꙕ
ꙕ	ꙕ
Ꙗ	Ꙗ
ꙗ	ꙗ
Ꙙ	Ꙙ
ꙙ	ꙙ
Ꙛ	Ꙛ
ꙛ	ꙛ
Ꙝ	Ꙝ
ꙝ	ꙝ
Ꙟ	Ꙟ
ꙟ	ꙟ
Ꙡ	Ꙡ
ꙡ	ꙡ
Ꙣ	Ꙣ
ꙣ	ꙣ
Ꙥ	Ꙥ
ꙥ	ꙥ
Ꙧ	Ꙧ
ꙧ	ꙧ
Ꙩ	Ꙩ
ꙩ	ꙩ
Ꙫ	Ꙫ
ꙫ	ꙫ
Ꙭ	Ꙭ
ꙭ	ꙭ
ꙮ	ꙮ
꙯	꙯
꙰	꙰
꙱	꙱
꙲	꙲
꙳	꙳
ꙴ	ꙴ
ꙵ	ꙵ
ꙶ	ꙶ
ꙷ	ꙷ
ꙸ	ꙸ
ꙹ	ꙹ
ꙺ	ꙺ
ꙻ	ꙻ
꙼	꙼
꙽	꙽
꙾	꙾
ꙿ	ꙿ
Ꚁ	Ꚁ
ꚁ	ꚁ
Ꚃ	Ꚃ
ꚃ	ꚃ
Ꚅ	Ꚅ
ꚅ	ꚅ
Ꚇ	Ꚇ
ꚇ	ꚇ
Ꚉ	Ꚉ
ꚉ	ꚉ
Ꚋ	Ꚋ
ꚋ	ꚋ
Ꚍ	Ꚍ
ꚍ	ꚍ
Ꚏ	Ꚏ
ꚏ	ꚏ
Ꚑ	Ꚑ
ꚑ	ꚑ
Ꚓ	Ꚓ
ꚓ	ꚓ
Ꚕ	Ꚕ
ꚕ	ꚕ
Ꚗ	Ꚗ
ꚗ	ꚗ
Ꚙ	Ꚙ
ꚙ	ꚙ
Ꚛ	Ꚛ
ꚛ	ꚛ
ꚜ	ꚜ
ꚝ	ꚝ
ꚞ	ꚞ
ꚟ	ꚟ
ꚠ	ꚠ
ꚡ	ꚡ
ꚢ	ꚢ
ꚣ	ꚣ
ꚤ	ꚤ
ꚥ	ꚥ
ꚦ	ꚦ
ꚧ	ꚧ
ꚨ	ꚨ
ꚩ	ꚩ
ꚪ	ꚪ
ꚫ	ꚫ
ꚬ	ꚬ
ꚭ	ꚭ
ꚮ	ꚮ
ꚯ	ꚯ
ꚰ	ꚰ
ꚱ	ꚱ
ꚲ	ꚲ
ꚳ	ꚳ
ꚴ	ꚴ
ꚵ	ꚵ
ꚶ	ꚶ
ꚷ	ꚷ
ꚸ	ꚸ
ꚹ	ꚹ
ꚺ	ꚺ
ꚻ	ꚻ
ꚼ	ꚼ
ꚽ	ꚽ
ꚾ	ꚾ
ꚿ	ꚿ
ꛀ	ꛀ
ꛁ	ꛁ
ꛂ	ꛂ
ꛃ	ꛃ
ꛄ	ꛄ
ꛅ	ꛅ
ꛆ	ꛆ
ꛇ	ꛇ
ꛈ	ꛈ
ꛉ	ꛉ
ꛊ	ꛊ
ꛋ	ꛋ
ꛌ	ꛌ
ꛍ	ꛍ
ꛎ	ꛎ
ꛏ	ꛏ
ꛐ	ꛐ
ꛑ	ꛑ
ꛒ	ꛒ
ꛓ	ꛓ
ꛔ	ꛔ
ꛕ	ꛕ
ꛖ	ꛖ
ꛗ	ꛗ
ꛘ	ꛘ
ꛙ	ꛙ
ꛚ	ꛚ
ꛛ	ꛛ
ꛜ	ꛜ
ꛝ	ꛝ
ꛞ	ꛞ
ꛟ	ꛟ
ꛠ	ꛠ
ꛡ	ꛡ
ꛢ	ꛢ
ꛣ	ꛣ
ꛤ	ꛤ
ꛥ	ꛥ
ꛦ	ꛦ
ꛧ	ꛧ
ꛨ	ꛨ
ꛩ	ꛩ
ꛪ	ꛪ
ꛫ	ꛫ
ꛬ	ꛬ
ꛭ	ꛭ
ꛮ	ꛮ
ꛯ	ꛯ
꛰	꛰
꛱	꛱
꛲	꛲
꛳	꛳
꛴	꛴
꛵	꛵
꛶	꛶
꛷	꛷
꛸	꛸
꛹	꛹
꛺	꛺
꛻	꛻
꛼	꛼
꛽	꛽
꛾	꛾
꛿	꛿
꜀	꜀
꜁	꜁
꜂	꜂
꜃	꜃
꜄	꜄
꜅	꜅
꜆	꜆
꜇	꜇
꜈	꜈
꜉	꜉
꜊	꜊
꜋	꜋
꜌	꜌
꜍	꜍
꜎	꜎
꜏	꜏
꜐	꜐
꜑	꜑
꜒	꜒
꜓	꜓
꜔	꜔
꜕	꜕
꜖	꜖
ꜗ	ꜗ
ꜘ	ꜘ
ꜙ	ꜙ
ꜚ	ꜚ
ꜛ	ꜛ
ꜜ	ꜜ
ꜝ	ꜝ
ꜞ	ꜞ
ꜟ	ꜟ
꜠	꜠
꜡	꜡
Ꜣ	Ꜣ
ꜣ	ꜣ
Ꜥ	Ꜥ
ꜥ	ꜥ
Ꜧ	Ꜧ
ꜧ	ꜧ
Ꜩ	Ꜩ
ꜩ	ꜩ
Ꜫ	Ꜫ
ꜫ	ꜫ
Ꜭ	Ꜭ
ꜭ	ꜭ
Ꜯ	Ꜯ
ꜯ	ꜯ
ꜰ	ꜰ
ꜱ	ꜱ
Ꜳ	Ꜳ
ꜳ	ꜳ
Ꜵ	Ꜵ
ꜵ	ꜵ
Ꜷ	Ꜷ
ꜷ	ꜷ
Ꜹ	Ꜹ
ꜹ	ꜹ
Ꜻ	Ꜻ
ꜻ	ꜻ
Ꜽ	Ꜽ
ꜽ	ꜽ
Ꜿ	Ꜿ
ꜿ	ꜿ
Ꝁ	Ꝁ
ꝁ	ꝁ
Ꝃ	Ꝃ
ꝃ	ꝃ
Ꝅ	Ꝅ
ꝅ	ꝅ
Ꝇ	Ꝇ
ꝇ	ꝇ
Ꝉ	Ꝉ
ꝉ	ꝉ
Ꝋ	Ꝋ
ꝋ	ꝋ
Ꝍ	Ꝍ
ꝍ	ꝍ
Ꝏ	Ꝏ
ꝏ	ꝏ
Ꝑ	Ꝑ
ꝑ	ꝑ
Ꝓ	Ꝓ
ꝓ	ꝓ
Ꝕ	Ꝕ
ꝕ	ꝕ
Ꝗ	Ꝗ
ꝗ	ꝗ
Ꝙ	Ꝙ
ꝙ	ꝙ
Ꝛ	Ꝛ
ꝛ	ꝛ
Ꝝ	Ꝝ
ꝝ	ꝝ
Ꝟ	Ꝟ
ꝟ	ꝟ
Ꝡ	Ꝡ
ꝡ	ꝡ
Ꝣ	Ꝣ
ꝣ	ꝣ
Ꝥ	Ꝥ
ꝥ	ꝥ
Ꝧ	Ꝧ
ꝧ	ꝧ
Ꝩ	Ꝩ
ꝩ	ꝩ
Ꝫ	Ꝫ
ꝫ	ꝫ
Ꝭ	Ꝭ
ꝭ	ꝭ
Ꝯ	Ꝯ
ꝯ	ꝯ
ꝰ	ꝰ
ꝱ	ꝱ
ꝲ	ꝲ
ꝳ	ꝳ
ꝴ	ꝴ
ꝵ	ꝵ
ꝶ	ꝶ
ꝷ	ꝷ
ꝸ	ꝸ
Ꝺ	Ꝺ
ꝺ	ꝺ
Ꝼ	Ꝼ
ꝼ	ꝼ
Ᵹ	Ᵹ
Ꝿ	Ꝿ
ꝿ	ꝿ
Ꞁ	Ꞁ
ꞁ	ꞁ
Ꞃ	Ꞃ
ꞃ	ꞃ
Ꞅ	Ꞅ
ꞅ	ꞅ
Ꞇ	Ꞇ
ꞇ	ꞇ
ꞈ	ꞈ
꞉	꞉
꞊	꞊
Ꞌ	Ꞌ
ꞌ	ꞌ
Ɥ	Ɥ
ꞎ	ꞎ
ꞏ	ꞏ
Ꞑ	Ꞑ
ꞑ	ꞑ
Ꞓ	Ꞓ
ꞓ	ꞓ
ꞔ	ꞔ
ꞕ	ꞕ
Ꞗ	Ꞗ
ꞗ	ꞗ
Ꞙ	Ꞙ
ꞙ	ꞙ
Ꞛ	Ꞛ
ꞛ	ꞛ
Ꞝ	Ꞝ
ꞝ	ꞝ
Ꞟ	Ꞟ
ꞟ	ꞟ
Ꞡ	Ꞡ
ꞡ	ꞡ
Ꞣ	Ꞣ
ꞣ	ꞣ
Ꞥ	Ꞥ
ꞥ	ꞥ
Ꞧ	Ꞧ
ꞧ	ꞧ
Ꞩ	Ꞩ
ꞩ	ꞩ
Ɦ	Ɦ
Ɜ	Ɜ
Ɡ	Ɡ
Ɬ	Ɬ
Ɪ	Ɪ
ꞯ	ꞯ
Ʞ	Ʞ
Ʇ	Ʇ
Ʝ	Ʝ
Ꭓ	Ꭓ
Ꞵ	Ꞵ
ꞵ	ꞵ
Ꞷ	Ꞷ
ꞷ	ꞷ
Ꞹ	Ꞹ
ꞹ	ꞹ
Ꞻ	Ꞻ
ꞻ	ꞻ
Ꞽ	Ꞽ
ꞽ	ꞽ
Ꞿ	Ꞿ
ꞿ	ꞿ
Ꟁ	Ꟁ
ꟁ	ꟁ
Ꟃ	Ꟃ
ꟃ	ꟃ
Ꞔ	Ꞔ
Ʂ	Ʂ
Ᶎ	Ᶎ
Ꟈ	Ꟈ
ꟈ	ꟈ
Ꟊ	Ꟊ
ꟊ	ꟊ
Ɤ	Ɤ
Ꟍ	Ꟍ
ꟍ	ꟍ
꟎	꟎
꟏	꟏
Ꟑ	Ꟑ
ꟑ	ꟑ
꟒	꟒
ꟓ	ꟓ
꟔	꟔
ꟕ	ꟕ
Ꟗ	Ꟗ
ꟗ	ꟗ
Ꟙ	Ꟙ
ꟙ	ꟙ
Ꟛ	Ꟛ
ꟛ	ꟛ
Ƛ	Ƛ
꟝	꟝
꟞	꟞
꟟	꟟
꟠	꟠
꟡	꟡
꟢	꟢
꟣	꟣
꟤	꟤
꟥	꟥
꟦	꟦
꟧	꟧
꟨	꟨
꟩	꟩
꟪	꟪
꟫	꟫
꟬	꟬
꟭	꟭
꟮	꟮
꟯	꟯
꟰	꟰
꟱	꟱
ꟲ	ꟲ
ꟳ	ꟳ
ꟴ	ꟴ
Ꟶ	Ꟶ
ꟶ	ꟶ
ꟷ	ꟷ
ꟸ	ꟸ
ꟹ	ꟹ
ꟺ	ꟺ
ꟻ	ꟻ
ꟼ	ꟼ
ꟽ	ꟽ
ꟾ	ꟾ
ꟿ	ꟿ
ꠀ	ꠀ
ꠁ	ꠁ
ꠂ	ꠂ
ꠃ	ꠃ
ꠄ	ꠄ
ꠅ	ꠅ
꠆	꠆
ꠇ	ꠇ
ꠈ	ꠈ
ꠉ	ꠉ
ꠊ	ꠊ
ꠋ	ꠋ
ꠌ	ꠌ
ꠍ	ꠍ
ꠎ	ꠎ
ꠏ	ꠏ
ꠐ	ꠐ
ꠑ	ꠑ
ꠒ	ꠒ
ꠓ	ꠓ
ꠔ	ꠔ
ꠕ	ꠕ
ꠖ	ꠖ
ꠗ	ꠗ
ꠘ	ꠘ
ꠙ	ꠙ
ꠚ	ꠚ
ꠛ	ꠛ
ꠜ	ꠜ
ꠝ	ꠝ
ꠞ	ꠞ
ꠟ	ꠟ
ꠠ	ꠠ
ꠡ	ꠡ
ꠢ	ꠢ
ꠣ	ꠣ
ꠤ	ꠤ
ꠥ	ꠥ
ꠦ	ꠦ
ꠧ	ꠧ
꠨	꠨
꠩	꠩
꠪	꠪
꠫	꠫
꠬	꠬
꠭	꠭
꠮	꠮
꠯	꠯
꠰	꠰
꠱	꠱
꠲	꠲
꠳	꠳
꠴	꠴
꠵	꠵
꠶	꠶
꠷	꠷
꠸	꠸
꠹	꠹
꠺	꠺
꠻	꠻
꠼	꠼
꠽	꠽
꠾	꠾
꠿	꠿
ꡀ	ꡀ
ꡁ	ꡁ
ꡂ	ꡂ
ꡃ	ꡃ
ꡄ	ꡄ
ꡅ	ꡅ
ꡆ	ꡆ
ꡇ	ꡇ
ꡈ	ꡈ
ꡉ	ꡉ
ꡊ	ꡊ
ꡋ	ꡋ
ꡌ	ꡌ
ꡍ	ꡍ
ꡎ	ꡎ
ꡏ	ꡏ
ꡐ	ꡐ
ꡑ	ꡑ
ꡒ	ꡒ
ꡓ	ꡓ
ꡔ	ꡔ
ꡕ	ꡕ
ꡖ	ꡖ
ꡗ	ꡗ
ꡘ	ꡘ
ꡙ	ꡙ
ꡚ	ꡚ
ꡛ	ꡛ
ꡜ	ꡜ
ꡝ	ꡝ
ꡞ	ꡞ
ꡟ	ꡟ
ꡠ	ꡠ
ꡡ	ꡡ
ꡢ	ꡢ
ꡣ	ꡣ
ꡤ	ꡤ
ꡥ	ꡥ
ꡦ	ꡦ
ꡧ	ꡧ
ꡨ	ꡨ
ꡩ	ꡩ
ꡪ	ꡪ
ꡫ	ꡫ
ꡬ	ꡬ
ꡭ	ꡭ
ꡮ	ꡮ
ꡯ	ꡯ
ꡰ	ꡰ
ꡱ	ꡱ
ꡲ	ꡲ
ꡳ	ꡳ
꡴	꡴
꡵	꡵
꡶	꡶
꡷	꡷
꡸	꡸
꡹	꡹
꡺	꡺
꡻	꡻
꡼	꡼
꡽	꡽
꡾	꡾
꡿	꡿
ꢀ	ꢀ
ꢁ	ꢁ
ꢂ	ꢂ
ꢃ	ꢃ
ꢄ	ꢄ
ꢅ	ꢅ
ꢆ	ꢆ
ꢇ	ꢇ
ꢈ	ꢈ
ꢉ	ꢉ
ꢊ	ꢊ
ꢋ	ꢋ
ꢌ	ꢌ
ꢍ	ꢍ
ꢎ	ꢎ
ꢏ	ꢏ
ꢐ	ꢐ
ꢑ	ꢑ
ꢒ	ꢒ
ꢓ	ꢓ
ꢔ	ꢔ
ꢕ	ꢕ
ꢖ	ꢖ
ꢗ	ꢗ
ꢘ	ꢘ
ꢙ	ꢙ
ꢚ	ꢚ
ꢛ	ꢛ
ꢜ	ꢜ
ꢝ	ꢝ
ꢞ	ꢞ
ꢟ	ꢟ
ꢠ	ꢠ
ꢡ	ꢡ
ꢢ	ꢢ
ꢣ	ꢣ
ꢤ	ꢤ
ꢥ	ꢥ
ꢦ	ꢦ
ꢧ	ꢧ
ꢨ	ꢨ
ꢩ	ꢩ
ꢪ	ꢪ
ꢫ	ꢫ
ꢬ	ꢬ
ꢭ	ꢭ
ꢮ	ꢮ
ꢯ	ꢯ
ꢰ	ꢰ
ꢱ	ꢱ
ꢲ	ꢲ
ꢳ	ꢳ
ꢴ	ꢴ
ꢵ	ꢵ
ꢶ	ꢶ
ꢷ	ꢷ
ꢸ	ꢸ
ꢹ	ꢹ
ꢺ	ꢺ
ꢻ	ꢻ
ꢼ	ꢼ
ꢽ	ꢽ
ꢾ	ꢾ
ꢿ	ꢿ
ꣀ	ꣀ
ꣁ	ꣁ
ꣂ	ꣂ
ꣃ	ꣃ
꣄	꣄
ꣅ	ꣅ
꣆	꣆
꣇	꣇
꣈	꣈
꣉	꣉
꣊	꣊
꣋	꣋
꣌	꣌
꣍	꣍
꣎	꣎
꣏	꣏
꣐	꣐
꣑	꣑
꣒	꣒
꣓	꣓
꣔	꣔
꣕	꣕
꣖	꣖
꣗	꣗
꣘	꣘
꣙	꣙
꣚	꣚
꣛	꣛
꣜	꣜
꣝	꣝
꣞	꣞
꣟	꣟
꣠	꣠
꣡	꣡
꣢	꣢
꣣	꣣
꣤	꣤
꣥	꣥
꣦	꣦
꣧	꣧
꣨	꣨
꣩	꣩
꣪	꣪
꣫	꣫
꣬	꣬
꣭	꣭
꣮	꣮
꣯	꣯
꣰	꣰
꣱	꣱
ꣲ	ꣲ
ꣳ	ꣳ
ꣴ	ꣴ
ꣵ	ꣵ
ꣶ	ꣶ
ꣷ	ꣷ
꣸	꣸
꣹	꣹
꣺	꣺
ꣻ	ꣻ
꣼	꣼
ꣽ	ꣽ
ꣾ	ꣾ
ꣿ	ꣿ
꤀	꤀
꤁	꤁
꤂	꤂
꤃	꤃
꤄	꤄
꤅	꤅
꤆	꤆
꤇	꤇
꤈	꤈
꤉	꤉
ꤊ	ꤊ
ꤋ	ꤋ
ꤌ	ꤌ
ꤍ	ꤍ
ꤎ	ꤎ
ꤏ	ꤏ
ꤐ	ꤐ
ꤑ	ꤑ
ꤒ	ꤒ
ꤓ	ꤓ
ꤔ	ꤔ
ꤕ	ꤕ
ꤖ	ꤖ
ꤗ	ꤗ
ꤘ	ꤘ
ꤙ	ꤙ
ꤚ	ꤚ
ꤛ	ꤛ
ꤜ	ꤜ
ꤝ	ꤝ
ꤞ	ꤞ
ꤟ	ꤟ
ꤠ	ꤠ
ꤡ	ꤡ
ꤢ	ꤢ
ꤣ	ꤣ
ꤤ	ꤤ
ꤥ	ꤥ
ꤦ	ꤦ
ꤧ	ꤧ
ꤨ	ꤨ
ꤩ	ꤩ
ꤪ	ꤪ
꤫	꤫
꤬	꤬
꤭	꤭
꤮	꤮
꤯	꤯
ꤰ	ꤰ
ꤱ	ꤱ
ꤲ	ꤲ
ꤳ	ꤳ
ꤴ	ꤴ
ꤵ	ꤵ
ꤶ	ꤶ
ꤷ	ꤷ
ꤸ	ꤸ
ꤹ	ꤹ
ꤺ	ꤺ
ꤻ	ꤻ
ꤼ	ꤼ
ꤽ	ꤽ
ꤾ	ꤾ
ꤿ	ꤿ
ꥀ	ꥀ
ꥁ	ꥁ
ꥂ	ꥂ
ꥃ	ꥃ
ꥄ	ꥄ
ꥅ	ꥅ
ꥆ	ꥆ
ꥇ	ꥇ
ꥈ	ꥈ
ꥉ	ꥉ
ꥊ	ꥊ
ꥋ	ꥋ
ꥌ	ꥌ
ꥍ	ꥍ
ꥎ	ꥎ
ꥏ	ꥏ
ꥐ	ꥐ
ꥑ	ꥑ
ꥒ	ꥒ
꥓	꥓
꥔	꥔
꥕	꥕
꥖	꥖
꥗	꥗
꥘	꥘
꥙	꥙
꥚	꥚
꥛	꥛
꥜	꥜
꥝	꥝
꥞	꥞
꥟	꥟
ꥠ	ꥠ
ꥡ	ꥡ
ꥢ	ꥢ
ꥣ	ꥣ
ꥤ	ꥤ
ꥥ	ꥥ
ꥦ	ꥦ
ꥧ	ꥧ
ꥨ	ꥨ
ꥩ	ꥩ
ꥪ	ꥪ
ꥫ	ꥫ
ꥬ	ꥬ
ꥭ	ꥭ
ꥮ	ꥮ
ꥯ	ꥯ
ꥰ	ꥰ
ꥱ	ꥱ
ꥲ	ꥲ
ꥳ	ꥳ
ꥴ	ꥴ
ꥵ	ꥵ
ꥶ	ꥶ
ꥷ	ꥷ
ꥸ	ꥸ
ꥹ	ꥹ
ꥺ	ꥺ
ꥻ	ꥻ
ꥼ	ꥼ
꥽	꥽
꥾	꥾
꥿	꥿
ꦀ	ꦀ
ꦁ	ꦁ
ꦂ	ꦂ
ꦃ	ꦃ
ꦄ	ꦄ
ꦅ	ꦅ
ꦆ	ꦆ
ꦇ	ꦇ
ꦈ	ꦈ
ꦉ	ꦉ
ꦊ	ꦊ
ꦋ	ꦋ
ꦌ	ꦌ
ꦍ	ꦍ
ꦎ	ꦎ
ꦏ	ꦏ
ꦐ	ꦐ
ꦑ	ꦑ
ꦒ	ꦒ
ꦓ	ꦓ
ꦔ	ꦔ
ꦕ	ꦕ
ꦖ	ꦖ
ꦗ	ꦗ
ꦘ	ꦘ
ꦙ	ꦙ
ꦚ	ꦚ
ꦛ	ꦛ
ꦜ	ꦜ
ꦝ	ꦝ
ꦞ	ꦞ
ꦟ	ꦟ
ꦠ	ꦠ
ꦡ	ꦡ
ꦢ	ꦢ
ꦣ	ꦣ
ꦤ	ꦤ
ꦥ	ꦥ
ꦦ	ꦦ
ꦧ	ꦧ
ꦨ	ꦨ
ꦩ	ꦩ
ꦪ	ꦪ
ꦫ	ꦫ
ꦬ	ꦬ
ꦭ	ꦭ
ꦮ	ꦮ
ꦯ	ꦯ
ꦰ	ꦰ
ꦱ	ꦱ
ꦲ	ꦲ
꦳	꦳
ꦴ	ꦴ
ꦵ	ꦵ
ꦶ	ꦶ
ꦷ	ꦷ
ꦸ	ꦸ
ꦹ	ꦹ
ꦺ	ꦺ
ꦻ	ꦻ
ꦼ	ꦼ
ꦽ	ꦽ
ꦾ	ꦾ
ꦿ	ꦿ
꧀	꧀
꧁	꧁
꧂	꧂
꧃	꧃
꧄	꧄
꧅	꧅
꧆	꧆
꧇	꧇
꧈	꧈
꧉	꧉
꧊	꧊
꧋	꧋
꧌	꧌
꧍	꧍
꧎	꧎
ꧏ	ꧏ
꧐	꧐
꧑	꧑
꧒	꧒
꧓	꧓
꧔	꧔
꧕	꧕
꧖	꧖
꧗	꧗
꧘	꧘
꧙	꧙
꧚	꧚
꧛	꧛
꧜	꧜
꧝	꧝
꧞	꧞
꧟	꧟
ꧠ	ꧠ
ꧡ	ꧡ
ꧢ	ꧢ
ꧣ	ꧣ
ꧤ	ꧤ
ꧥ	ꧥ
ꧦ	ꧦ
ꧧ	ꧧ
ꧨ	ꧨ
ꧩ	ꧩ
ꧪ	ꧪ
ꧫ	ꧫ
ꧬ	ꧬ
ꧭ	ꧭ
ꧮ	ꧮ
ꧯ	ꧯ
꧰	꧰
꧱	꧱
꧲	꧲
꧳	꧳
꧴	꧴
꧵	꧵
꧶	꧶
꧷	꧷
꧸	꧸
꧹	꧹
ꧺ	ꧺ
ꧻ	ꧻ
ꧼ	ꧼ
ꧽ	ꧽ
ꧾ	ꧾ
꧿	꧿
ꨀ	ꨀ
ꨁ	ꨁ
ꨂ	ꨂ
ꨃ	ꨃ
ꨄ	ꨄ
ꨅ	ꨅ
ꨆ	ꨆ
ꨇ	ꨇ
ꨈ	ꨈ
ꨉ	ꨉ
ꨊ	ꨊ
ꨋ	ꨋ
ꨌ	ꨌ
ꨍ	ꨍ
ꨎ	ꨎ
ꨏ	ꨏ
ꨐ	ꨐ
ꨑ	ꨑ
ꨒ	ꨒ
ꨓ	ꨓ
ꨔ	ꨔ
ꨕ	ꨕ
ꨖ	ꨖ
ꨗ	ꨗ
ꨘ	ꨘ
ꨙ	ꨙ
ꨚ	ꨚ
ꨛ	ꨛ
ꨜ	ꨜ
ꨝ	ꨝ
ꨞ	ꨞ
ꨟ	ꨟ
ꨠ	ꨠ
ꨡ	ꨡ
ꨢ	ꨢ
ꨣ	ꨣ
ꨤ	ꨤ
ꨥ	ꨥ
ꨦ	ꨦ
ꨧ	ꨧ
ꨨ	ꨨ
ꨩ	ꨩ
ꨪ	ꨪ
ꨫ	ꨫ
ꨬ	ꨬ
ꨭ	ꨭ
ꨮ	ꨮ
ꨯ	ꨯ
ꨰ	ꨰ
ꨱ	ꨱ
ꨲ	ꨲ
ꨳ	ꨳ
ꨴ	ꨴ
ꨵ	ꨵ
ꨶ	ꨶ
꨷	꨷
꨸	꨸
꨹	꨹
꨺	꨺
꨻	꨻
꨼	꨼
꨽	꨽
꨾	꨾
꨿	꨿
ꩀ	ꩀ
ꩁ	ꩁ
ꩂ	ꩂ
ꩃ	ꩃ
ꩄ	ꩄ
ꩅ	ꩅ
ꩆ	ꩆ
ꩇ	ꩇ
ꩈ	ꩈ
ꩉ	ꩉ
ꩊ	ꩊ
ꩋ	ꩋ
ꩌ	ꩌ
ꩍ	ꩍ
꩎	꩎
꩏	꩏
꩐	꩐
꩑	꩑
꩒	꩒
꩓	꩓
꩔	꩔
꩕	꩕
꩖	꩖
꩗	꩗
꩘	꩘
꩙	꩙
꩚	꩚
꩛	꩛
꩜	꩜
꩝	꩝
꩞	꩞
꩟	꩟
ꩠ	ꩠ
ꩡ	ꩡ
ꩢ	ꩢ
ꩣ	ꩣ
ꩤ	ꩤ
ꩥ	ꩥ
ꩦ	ꩦ
ꩧ	ꩧ
ꩨ	ꩨ
ꩩ	ꩩ
ꩪ	ꩪ
ꩫ	ꩫ
ꩬ	ꩬ
ꩭ	ꩭ
ꩮ	ꩮ
ꩯ	ꩯ
ꩰ	ꩰ
ꩱ	ꩱ
ꩲ	ꩲ
ꩳ	ꩳ
ꩴ	ꩴ
ꩵ	ꩵ
ꩶ	ꩶ
꩷	꩷
꩸	꩸
꩹	꩹
ꩺ	ꩺ
ꩻ	ꩻ
ꩼ	ꩼ
ꩽ	ꩽ
ꩾ	ꩾ
ꩿ	ꩿ
ꪀ	ꪀ
ꪁ	ꪁ
ꪂ	ꪂ
ꪃ	ꪃ
ꪄ	ꪄ
ꪅ	ꪅ
ꪆ	ꪆ
ꪇ	ꪇ
ꪈ	ꪈ
ꪉ	ꪉ
ꪊ	ꪊ
ꪋ	ꪋ
ꪌ	ꪌ
ꪍ	ꪍ
ꪎ	ꪎ
ꪏ	ꪏ
ꪐ	ꪐ
ꪑ	ꪑ
ꪒ	ꪒ
ꪓ	ꪓ
ꪔ	ꪔ
ꪕ	ꪕ
ꪖ	ꪖ
ꪗ	ꪗ
ꪘ	ꪘ
ꪙ	ꪙ
ꪚ	ꪚ
ꪛ	ꪛ
ꪜ	ꪜ
ꪝ	ꪝ
ꪞ	ꪞ
ꪟ	ꪟ
ꪠ	ꪠ
ꪡ	ꪡ
ꪢ	ꪢ
ꪣ	ꪣ
ꪤ	ꪤ
ꪥ	ꪥ
ꪦ	ꪦ
ꪧ	ꪧ
ꪨ	ꪨ
ꪩ	ꪩ
ꪪ	ꪪ
ꪫ	ꪫ
ꪬ	ꪬ
ꪭ	ꪭ
ꪮ	ꪮ
ꪯ	ꪯ
ꪰ	ꪰ
ꪱ	ꪱ
ꪲ	ꪲ
ꪳ	ꪳ
ꪴ	ꪴ
ꪵ	ꪵ
ꪶ	ꪶ
ꪷ	ꪷ
ꪸ	ꪸ
ꪹ	ꪹ
ꪺ	ꪺ
ꪻ	ꪻ
ꪼ	ꪼ
ꪽ	ꪽ
ꪾ	ꪾ
꪿	꪿
ꫀ	ꫀ
꫁	꫁
ꫂ	ꫂ
꫃	꫃
꫄	꫄
꫅	꫅
꫆	꫆
꫇	꫇
꫈	꫈
꫉	꫉
꫊	꫊
꫋	꫋
꫌	꫌
꫍	꫍
꫎	꫎
꫏	꫏
꫐	꫐
꫑	꫑
꫒	꫒
꫓	꫓
꫔	꫔
꫕	꫕
꫖	꫖
꫗	꫗
꫘	꫘
꫙	꫙
꫚	꫚
ꫛ	ꫛ
ꫜ	ꫜ
ꫝ	ꫝ
꫞	꫞
꫟	꫟
ꫠ	ꫠ
ꫡ	ꫡ
ꫢ	ꫢ
ꫣ	ꫣ
ꫤ	ꫤ
ꫥ	ꫥ
ꫦ	ꫦ
ꫧ	ꫧ
ꫨ	ꫨ
ꫩ	ꫩ
ꫪ	ꫪ
ꫫ	ꫫ
ꫬ	ꫬ
ꫭ	ꫭ
ꫮ	ꫮ
ꫯ	ꫯ
꫰	꫰
꫱	꫱
ꫲ	ꫲ
ꫳ	ꫳ
ꫴ	ꫴ
ꫵ	ꫵ
꫶	꫶
꫷	꫷
꫸	꫸
꫹	꫹
꫺	꫺
꫻	꫻
꫼	꫼
꫽	꫽
꫾	꫾
꫿	꫿
꬀	꬀
ꬁ	ꬁ
ꬂ	ꬂ
ꬃ	ꬃ
ꬄ	ꬄ
ꬅ	ꬅ
ꬆ	ꬆ
꬇	꬇
꬈	꬈
ꬉ	ꬉ
ꬊ	ꬊ
ꬋ	ꬋ
ꬌ	ꬌ
ꬍ	ꬍ
ꬎ	ꬎ
꬏	꬏
꬐	꬐
ꬑ	ꬑ
ꬒ	ꬒ
ꬓ	ꬓ
ꬔ	ꬔ
ꬕ	ꬕ
ꬖ	ꬖ
꬗	꬗
꬘	꬘
꬙	꬙
꬚	꬚
꬛	꬛
꬜	꬜
꬝	꬝
꬞	꬞
꬟	꬟
ꬠ	ꬠ
ꬡ	ꬡ
ꬢ	ꬢ
ꬣ	ꬣ
ꬤ	ꬤ
ꬥ	ꬥ
ꬦ	ꬦ
꬧	꬧
ꬨ	ꬨ
ꬩ	ꬩ
ꬪ	ꬪ
ꬫ	ꬫ
ꬬ	ꬬ
ꬭ	ꬭ
ꬮ	ꬮ
꬯	꬯
ꬰ	ꬰ
ꬱ	ꬱ
ꬲ	ꬲ
ꬳ	ꬳ
ꬴ	ꬴ
ꬵ	ꬵ
ꬶ	ꬶ
ꬷ	ꬷ
ꬸ	ꬸ
ꬹ	ꬹ
ꬺ	ꬺ
ꬻ	ꬻ
ꬼ	ꬼ
ꬽ	ꬽ
ꬾ	ꬾ
ꬿ	ꬿ
ꭀ	ꭀ
ꭁ	ꭁ
ꭂ	ꭂ
ꭃ	ꭃ
ꭄ	ꭄ
ꭅ	ꭅ
ꭆ	ꭆ
ꭇ	ꭇ
ꭈ	ꭈ
ꭉ	ꭉ
ꭊ	ꭊ
ꭋ	ꭋ
ꭌ	ꭌ
ꭍ	ꭍ
ꭎ	ꭎ
ꭏ	ꭏ
ꭐ	ꭐ
ꭑ	ꭑ
ꭒ	ꭒ
ꭓ	ꭓ
ꭔ	ꭔ
ꭕ	ꭕ
ꭖ	ꭖ
ꭗ	ꭗ
ꭘ	ꭘ
ꭙ	ꭙ
ꭚ	ꭚ
꭛	꭛
ꭜ	ꭜ
ꭝ	ꭝ
ꭞ	ꭞ
ꭟ	ꭟ
ꭠ	ꭠ
ꭡ	ꭡ
ꭢ	ꭢ
ꭣ	ꭣ
ꭤ	ꭤ
ꭥ	ꭥ
ꭦ	ꭦ
ꭧ	ꭧ
ꭨ	ꭨ
ꭩ	ꭩ
꭪	꭪
꭫	꭫
꭬	꭬
꭭	꭭
꭮	꭮
꭯	꭯
ꭰ	ꭰ
ꭱ	ꭱ
ꭲ	ꭲ
ꭳ	ꭳ
ꭴ	ꭴ
ꭵ	ꭵ
ꭶ	ꭶ
ꭷ	ꭷ
ꭸ	ꭸ
ꭹ	ꭹ
ꭺ	ꭺ
ꭻ	ꭻ
ꭼ	ꭼ
ꭽ	ꭽ
ꭾ	ꭾ
ꭿ	ꭿ
ꮀ	ꮀ
ꮁ	ꮁ
ꮂ	ꮂ
ꮃ	ꮃ
ꮄ	ꮄ
ꮅ	ꮅ
ꮆ	ꮆ
ꮇ	ꮇ
ꮈ	ꮈ
ꮉ	ꮉ
ꮊ	ꮊ
ꮋ	ꮋ
ꮌ	ꮌ
ꮍ	ꮍ
ꮎ	ꮎ
ꮏ	ꮏ
ꮐ	ꮐ
ꮑ	ꮑ
ꮒ	ꮒ
ꮓ	ꮓ
ꮔ	ꮔ
ꮕ	ꮕ
ꮖ	ꮖ
ꮗ	ꮗ
ꮘ	ꮘ
ꮙ	ꮙ
ꮚ	ꮚ
ꮛ	ꮛ
ꮜ	ꮜ
ꮝ	ꮝ
ꮞ	ꮞ
ꮟ	ꮟ
ꮠ	ꮠ
ꮡ	ꮡ
ꮢ	ꮢ
ꮣ	ꮣ
ꮤ	ꮤ
ꮥ	ꮥ
ꮦ	ꮦ
ꮧ	ꮧ
ꮨ	ꮨ
ꮩ	ꮩ
ꮪ	ꮪ
ꮫ	ꮫ
ꮬ	ꮬ
ꮭ	ꮭ
ꮮ	ꮮ
ꮯ	ꮯ
ꮰ	ꮰ
ꮱ	ꮱ
ꮲ	ꮲ
ꮳ	ꮳ
ꮴ	ꮴ
ꮵ	ꮵ
ꮶ	ꮶ
ꮷ	ꮷ
ꮸ	ꮸ
ꮹ	ꮹ
ꮺ	ꮺ
ꮻ	ꮻ
ꮼ	ꮼ
ꮽ	ꮽ
ꮾ	ꮾ
ꮿ	ꮿ
ꯀ	ꯀ
ꯁ	ꯁ
ꯂ	ꯂ
ꯃ	ꯃ
ꯄ	ꯄ
ꯅ	ꯅ
ꯆ	ꯆ
ꯇ	ꯇ
ꯈ	ꯈ
ꯉ	ꯉ
ꯊ	ꯊ
ꯋ	ꯋ
ꯌ	ꯌ
ꯍ	ꯍ
ꯎ	ꯎ
ꯏ	ꯏ
ꯐ	ꯐ
ꯑ	ꯑ
ꯒ	ꯒ
ꯓ	ꯓ
ꯔ	ꯔ
ꯕ	ꯕ
ꯖ	ꯖ
ꯗ	ꯗ
ꯘ	ꯘ
ꯙ	ꯙ
ꯚ	ꯚ
ꯛ	ꯛ
ꯜ	ꯜ
ꯝ	ꯝ
ꯞ	ꯞ
ꯟ	ꯟ
ꯠ	ꯠ
ꯡ	ꯡ
ꯢ	ꯢ
ꯣ	ꯣ
ꯤ	ꯤ
ꯥ	ꯥ
ꯦ	ꯦ
ꯧ	ꯧ
ꯨ	ꯨ
ꯩ	ꯩ
ꯪ	ꯪ
꯫	꯫
꯬	꯬
꯭	꯭
꯮	꯮
꯯	꯯
꯰	꯰
꯱	꯱
꯲	꯲
꯳	꯳
꯴	꯴
꯵	꯵
꯶	꯶
꯷	꯷
꯸	꯸
꯹	꯹
꯺	꯺
꯻	꯻
꯼	꯼
꯽	꯽
꯾	꯾
꯿	꯿
가	가
각	각
갂	갂
갃	갃
간	간
갅	갅
갆	갆
갇	갇
갈	갈
갉	갉
갊	갊
갋	갋
갌	갌
갍	갍
갎	갎
갏	갏
감	감
갑	갑
값	값
갓	갓
갔	갔
강	강
갖	갖
갗	갗
갘	갘
같	같
갚	갚
갛	갛
개	개
객	객
갞	갞
갟	갟
갠	갠
갡	갡
갢	갢
갣	갣
갤	갤
갥	갥
갦	갦
갧	갧
갨	갨
갩	갩
갪	갪
갫	갫
갬	갬
갭	갭
갮	갮
갯	갯
갰	갰
갱	갱
갲	갲
갳	갳
갴	갴
갵	갵
갶	갶
갷	갷
갸	갸
갹	갹
갺	갺
갻	갻
갼	갼
갽	갽
갾	갾
갿	갿
걀	걀
걁	걁
걂	걂
걃	걃
걄	걄
걅	걅
걆	걆
걇	걇
걈	걈
걉	걉
걊	걊
걋	걋
걌	걌
걍	걍
걎	걎
걏	걏
걐	걐
걑	걑
걒	걒
걓	걓
걔	걔
걕	걕
걖	걖
걗	걗
걘	걘
걙	걙
걚	걚
걛	걛
걜	걜
걝	걝
걞	걞
걟	걟
걠	걠
걡	걡
걢	걢
걣	걣
걤	걤
걥	걥
걦	걦
걧	걧
걨	걨
걩	걩
걪	걪
걫	걫
걬	걬
걭	걭
걮	걮
걯	걯
거	거
걱	걱
걲	걲
걳	걳
건	건
걵	걵
걶	걶
걷	걷
걸	걸
걹	걹
걺	걺
걻	걻
걼	걼
걽	걽
걾	걾
걿	걿
검	검
겁	겁
겂	겂
것	것
겄	겄
겅	겅
겆	겆
겇	겇
겈	겈
겉	겉
겊	겊
겋	겋
게	게
겍	겍
겎	겎
겏	겏
겐	겐
겑	겑
겒	겒
겓	겓
겔	겔
겕	겕
겖	겖
겗	겗
겘	겘
겙	겙
겚	겚
겛	겛
겜	겜
겝	겝
겞	겞
겟	겟
겠	겠
겡	겡
겢	겢
겣	겣
겤	겤
겥	겥
겦	겦
겧	겧
겨	겨
격	격
겪	겪
겫	겫
견	견
겭	겭
겮	겮
겯	겯
결	결
겱	겱
겲	겲
겳	겳
겴	겴
겵	겵
겶	겶
겷	겷
겸	겸
겹	겹
겺	겺
겻	겻
겼	겼
경	경
겾	겾
겿	겿
곀	곀
곁	곁
곂	곂
곃	곃
계	계
곅	곅
곆	곆
곇	곇
곈	곈
곉	곉
곊	곊
곋	곋
곌	곌
곍	곍
곎	곎
곏	곏
곐	곐
곑	곑
곒	곒
곓	곓
곔	곔
곕	곕
곖	곖
곗	곗
곘	곘
곙	곙
곚	곚
곛	곛
곜	곜
곝	곝
곞	곞
곟	곟
고	고
곡	곡
곢	곢
곣	곣
곤	곤
곥	곥
곦	곦
곧	곧
골	골
곩	곩
곪	곪
곫	곫
곬	곬
곭	곭
곮	곮
곯	곯
곰	곰
곱	곱
곲	곲
곳	곳
곴	곴
공	공
곶	곶
곷	곷
곸	곸
곹	곹
곺	곺
곻	곻
과	과
곽	곽
곾	곾
곿	곿
관	관
괁	괁
괂	괂
괃	괃
괄	괄
괅	괅
괆	괆
괇	괇
괈	괈
괉	괉
괊	괊
괋	괋
괌	괌
괍	괍
괎	괎
괏	괏
괐	괐
광	광
괒	괒
괓	괓
괔	괔
괕	괕
괖	괖
괗	괗
괘	괘
괙	괙
괚	괚
괛	괛
괜	괜
괝	괝
괞	괞
괟	괟
괠	괠
괡	괡
괢	괢
괣	괣
괤	괤
괥	괥
괦	괦
괧	괧
괨	괨
괩	괩
괪	괪
괫	괫
괬	괬
괭	괭
괮	괮
괯	괯
괰	괰
괱	괱
괲	괲
괳	괳
괴	괴
괵	괵
괶	괶
괷	괷
괸	괸
괹	괹
괺	괺
괻	괻
괼	괼
괽	괽
괾	괾
괿	괿
굀	굀
굁	굁
굂	굂
굃	굃
굄	굄
굅	굅
굆	굆
굇	굇
굈	굈
굉	굉
굊	굊
굋	굋
굌	굌
굍	굍
굎	굎
굏	굏
교	교
굑	굑
굒	굒
굓	굓
굔	굔
굕	굕
굖	굖
굗	굗
굘	굘
굙	굙
굚	굚
굛	굛
굜	굜
굝	굝
굞	굞
굟	굟
굠	굠
굡	굡
굢	굢
굣	굣
굤	굤
굥	굥
굦	굦
굧	굧
굨	굨
굩	굩
굪	굪
굫	굫
구	구
국	국
굮	굮
굯	굯
군	군
굱	굱
굲	굲
굳	굳
굴	굴
굵	굵
굶	굶
굷	굷
굸	굸
굹	굹
굺	굺
굻	굻
굼	굼
굽	굽
굾	굾
굿	굿
궀	궀
궁	궁
궂	궂
궃	궃
궄	궄
궅	궅
궆	궆
궇	궇
궈	궈
궉	궉
궊	궊
궋	궋
권	권
궍	궍
궎	궎
궏	궏
궐	궐
궑	궑
궒	궒
궓	궓
궔	궔
궕	궕
궖	궖
궗	궗
궘	궘
궙	궙
궚	궚
궛	궛
궜	궜
궝	궝
궞	궞
궟	궟
궠	궠
궡	궡
궢	궢
궣	궣
궤	궤
궥	궥
궦	궦
궧	궧
궨	궨
궩	궩
궪	궪
궫	궫
궬	궬
궭	궭
궮	궮
궯	궯
궰	궰
궱	궱
궲	궲
궳	궳
궴	궴
궵	궵
궶	궶
궷	궷
궸	궸
궹	궹
궺	궺
궻	궻
궼	궼
궽	궽
궾	궾
궿	궿
귀	귀
귁	귁
귂	귂
귃	귃
귄	귄
귅	귅
귆	귆
귇	귇
귈	귈
귉	귉
귊	귊
귋	귋
귌	귌
귍	귍
귎	귎
귏	귏
귐	귐
귑	귑
귒	귒
귓	귓
귔	귔
귕	귕
귖	귖
귗	귗
귘	귘
귙	귙
귚	귚
귛	귛
규	규
귝	귝
귞	귞
귟	귟
균	균
귡	귡
귢	귢
귣	귣
귤	귤
귥	귥
귦	귦
귧	귧
귨	귨
귩	귩
귪	귪
귫	귫
귬	귬
귭	귭
귮	귮
귯	귯
귰	귰
귱	귱
귲	귲
귳	귳
귴	귴
귵	귵
귶	귶
귷	귷
그	그
극	극
귺	귺
귻	귻
근	근
귽	귽
귾	귾
귿	귿
글	글
긁	긁
긂	긂
긃	긃
긄	긄
긅	긅
긆	긆
긇	긇
금	금
급	급
긊	긊
긋	긋
긌	긌
긍	긍
긎	긎
긏	긏
긐	긐
긑	긑
긒	긒
긓	긓
긔	긔
긕	긕
긖	긖
긗	긗
긘	긘
긙	긙
긚	긚
긛	긛
긜	긜
긝	긝
긞	긞
긟	긟
긠	긠
긡	긡
긢	긢
긣	긣
긤	긤
긥	긥
긦	긦
긧	긧
긨	긨
긩	긩
긪	긪
긫	긫
긬	긬
긭	긭
긮	긮
긯	긯
기	기
긱	긱
긲	긲
긳	긳
긴	긴
긵	긵
긶	긶
긷	긷
길	길
긹	긹
긺	긺
긻	긻
긼	긼
긽	긽
긾	긾
긿	긿
김	김
깁	깁
깂	깂
깃	깃
깄	깄
깅	깅
깆	깆
깇	깇
깈	깈
깉	깉
깊	깊
깋	깋
까	까
깍	깍
깎	깎
깏	깏
깐	깐
깑	깑
깒	깒
깓	깓
깔	깔
깕	깕
깖	깖
깗	깗
깘	깘
깙	깙
깚	깚
깛	깛
깜	깜
깝	깝
깞	깞
깟	깟
깠	깠
깡	깡
깢	깢
깣	깣
깤	깤
깥	깥
깦	깦
깧	깧
깨	깨
깩	깩
깪	깪
깫	깫
깬	깬
깭	깭
깮	깮
깯	깯
깰	깰
깱	깱
깲	깲
깳	깳
깴	깴
깵	깵
깶	깶
깷	깷
깸	깸
깹	깹
깺	깺
깻	깻
깼	깼
깽	깽
깾	깾
깿	깿
꺀	꺀
꺁	꺁
꺂	꺂
꺃	꺃
꺄	꺄
꺅	꺅
꺆	꺆
꺇	꺇
꺈	꺈
꺉	꺉
꺊	꺊
꺋	꺋
꺌	꺌
꺍	꺍
꺎	꺎
꺏	꺏
꺐	꺐
꺑	꺑
꺒	꺒
꺓	꺓
꺔	꺔
꺕	꺕
꺖	꺖
꺗	꺗
꺘	꺘
꺙	꺙
꺚	꺚
꺛	꺛
꺜	꺜
꺝	꺝
꺞	꺞
꺟	꺟
꺠	꺠
꺡	꺡
꺢	꺢
꺣	꺣
꺤	꺤
꺥	꺥
꺦	꺦
꺧	꺧
꺨	꺨
꺩	꺩
꺪	꺪
꺫	꺫
꺬	꺬
꺭	꺭
꺮	꺮
꺯	꺯
꺰	꺰
꺱	꺱
꺲	꺲
꺳	꺳
꺴	꺴
꺵	꺵
꺶	꺶
꺷	꺷
꺸	꺸
꺹	꺹
꺺	꺺
꺻	꺻
꺼	꺼
꺽	꺽
꺾	꺾
꺿	꺿
껀	껀
껁	껁
껂	껂
껃	껃
껄	껄
껅	껅
껆	껆
껇	껇
껈	껈
껉	껉
껊	껊
껋	껋
껌	껌
껍	껍
껎	껎
껏	껏
껐	껐
껑	껑
껒	껒
껓	껓
껔	껔
껕	껕
껖	껖
껗	껗
께	께
껙	껙
껚	껚
껛	껛
껜	껜
껝	껝
껞	껞
껟	껟
껠	껠
껡	껡
껢	껢
껣	껣
껤	껤
껥	껥
껦	껦
껧	껧
껨	껨
껩	껩
껪	껪
껫	껫
껬	껬
껭	껭
껮	껮
껯	껯
껰	껰
껱	껱
껲	껲
껳	껳
껴	껴
껵	껵
껶	껶
껷	껷
껸	껸
껹	껹
껺	껺
껻	껻
껼	껼
껽	껽
껾	껾
껿	껿
꼀	꼀
꼁	꼁
꼂	꼂
꼃	꼃
꼄	꼄
꼅	꼅
꼆	꼆
꼇	꼇
꼈	꼈
꼉	꼉
꼊	꼊
꼋	꼋
꼌	꼌
꼍	꼍
꼎	꼎
꼏	꼏
꼐	꼐
꼑	꼑
꼒	꼒
꼓	꼓
꼔	꼔
꼕	꼕
꼖	꼖
꼗	꼗
꼘	꼘
꼙	꼙
꼚	꼚
꼛	꼛
꼜	꼜
꼝	꼝
꼞	꼞
꼟	꼟
꼠	꼠
꼡	꼡
꼢	꼢
꼣	꼣
꼤	꼤
꼥	꼥
꼦	꼦
꼧	꼧
꼨	꼨
꼩	꼩
꼪	꼪
꼫	꼫
꼬	꼬
꼭	꼭
꼮	꼮
꼯	꼯
꼰	꼰
꼱	꼱
꼲	꼲
꼳	꼳
꼴	꼴
꼵	꼵
꼶	꼶
꼷	꼷
꼸	꼸
꼹	꼹
꼺	꼺
꼻	꼻
꼼	꼼
꼽	꼽
꼾	꼾
꼿	꼿
꽀	꽀
꽁	꽁
꽂	꽂
꽃	꽃
꽄	꽄
꽅	꽅
꽆	꽆
꽇	꽇
꽈	꽈
꽉	꽉
꽊	꽊
꽋	꽋
꽌	꽌
꽍	꽍
꽎	꽎
꽏	꽏
꽐	꽐
꽑	꽑
꽒	꽒
꽓	꽓
꽔	꽔
꽕	꽕
꽖	꽖
꽗	꽗
꽘	꽘
꽙	꽙
꽚	꽚
꽛	꽛
꽜	꽜
꽝	꽝
꽞	꽞
꽟	꽟
꽠	꽠
꽡	꽡
꽢	꽢
꽣	꽣
꽤	꽤
꽥	꽥
꽦	꽦
꽧	꽧
꽨	꽨
꽩	꽩
꽪	꽪
꽫	꽫
꽬	꽬
꽭	꽭
꽮	꽮
꽯	꽯
꽰	꽰
꽱	꽱
꽲	꽲
꽳	꽳
꽴	꽴
꽵	꽵
꽶	꽶
꽷	꽷
꽸	꽸
꽹	꽹
꽺	꽺
꽻	꽻
꽼	꽼
꽽	꽽
꽾	꽾
꽿	꽿
꾀	꾀
꾁	꾁
꾂	꾂
꾃	꾃
꾄	꾄
꾅	꾅
꾆	꾆
꾇	꾇
꾈	꾈
꾉	꾉
꾊	꾊
꾋	꾋
꾌	꾌
꾍	꾍
꾎	꾎
꾏	꾏
꾐	꾐
꾑	꾑
꾒	꾒
꾓	꾓
꾔	꾔
꾕	꾕
꾖	꾖
꾗	꾗
꾘	꾘
꾙	꾙
꾚	꾚
꾛	꾛
꾜	꾜
꾝	꾝
꾞	꾞
꾟	꾟
꾠	꾠
꾡	꾡
꾢	꾢
꾣	꾣
꾤	꾤
꾥	꾥
꾦	꾦
꾧	꾧
꾨	꾨
꾩	꾩
꾪	꾪
꾫	꾫
꾬	꾬
꾭	꾭
꾮	꾮
꾯	꾯
꾰	꾰
꾱	꾱
꾲	꾲
꾳	꾳
꾴	꾴
꾵	꾵
꾶	꾶
꾷	꾷
꾸	꾸
꾹	꾹
꾺	꾺
꾻	꾻
꾼	꾼
꾽	꾽
꾾	꾾
꾿	꾿
꿀	꿀
꿁	꿁
꿂	꿂
꿃	꿃
꿄	꿄
꿅	꿅
꿆	꿆
꿇	꿇
꿈	꿈
꿉	꿉
꿊	꿊
꿋	꿋
꿌	꿌
꿍	꿍
꿎	꿎
꿏	꿏
꿐	꿐
꿑	꿑
꿒	꿒
꿓	꿓
꿔	꿔
꿕	꿕
꿖	꿖
꿗	꿗
꿘	꿘
꿙	꿙
꿚	꿚
꿛	꿛
꿜	꿜
꿝	꿝
꿞	꿞
꿟	꿟
꿠	꿠
꿡	꿡
꿢	꿢
꿣	꿣
꿤	꿤
꿥	꿥
꿦	꿦
꿧	꿧
꿨	꿨
꿩	꿩
꿪	꿪
꿫	꿫
꿬	꿬
꿭	꿭
꿮	꿮
꿯	꿯
꿰	꿰
꿱	꿱
꿲	꿲
꿳	꿳
꿴	꿴
꿵	꿵
꿶	꿶
꿷	꿷
꿸	꿸
꿹	꿹
꿺	꿺
꿻	꿻
꿼	꿼
꿽	꿽
꿾	꿾
꿿	꿿
뀀	뀀
뀁	뀁
뀂	뀂
뀃	뀃
뀄	뀄
뀅	뀅
뀆	뀆
뀇	뀇
뀈	뀈
뀉	뀉
뀊	뀊
뀋	뀋
뀌	뀌
뀍	뀍
뀎	뀎
뀏	뀏
뀐	뀐
뀑	뀑
뀒	뀒
뀓	뀓
뀔	뀔
뀕	뀕
뀖	뀖
뀗	뀗
뀘	뀘
뀙	뀙
뀚	뀚
뀛	뀛
뀜	뀜
뀝	뀝
뀞	뀞
뀟	뀟
뀠	뀠
뀡	뀡
뀢	뀢
뀣	뀣
뀤	뀤
뀥	뀥
뀦	뀦
뀧	뀧
뀨	뀨
뀩	뀩
뀪	뀪
뀫	뀫
뀬	뀬
뀭	뀭
뀮	뀮
뀯	뀯
뀰	뀰
뀱	뀱
뀲	뀲
뀳	뀳
뀴	뀴
뀵	뀵
뀶	뀶
뀷	뀷
뀸	뀸
뀹	뀹
뀺	뀺
뀻	뀻
뀼	뀼
뀽	뀽
뀾	뀾
뀿	뀿
끀	끀
끁	끁
끂	끂
끃	끃
끄	끄
끅	끅
끆	끆
끇	끇
끈	끈
끉	끉
끊	끊
끋	끋
끌	끌
끍	끍
끎	끎
끏	끏
끐	끐
끑	끑
끒	끒
끓	끓
끔	끔
끕	끕
끖	끖
끗	끗
끘	끘
끙	끙
끚	끚
끛	끛
끜	끜
끝	끝
끞	끞
끟	끟
끠	끠
끡	끡
끢	끢
끣	끣
끤	끤
끥	끥
끦	끦
끧	끧
끨	끨
끩	끩
끪	끪
끫	끫
끬	끬
끭	끭
끮	끮
끯	끯
끰	끰
끱	끱
끲	끲
끳	끳
끴	끴
끵	끵
끶	끶
끷	끷
끸	끸
끹	끹
끺	끺
끻	끻
끼	끼
끽	끽
끾	끾
끿	끿
낀	낀
낁	낁
낂	낂
낃	낃
낄	낄
낅	낅
낆	낆
낇	낇
낈	낈
낉	낉
낊	낊
낋	낋
낌	낌
낍	낍
낎	낎
낏	낏
낐	낐
낑	낑
낒	낒
낓	낓
낔	낔
낕	낕
낖	낖
낗	낗
나	나
낙	낙
낚	낚
낛	낛
난	난
낝	낝
낞	낞
낟	낟
날	날
낡	낡
낢	낢
낣	낣
낤	낤
낥	낥
낦	낦
낧	낧
남	남
납	납
낪	낪
낫	낫
났	났
낭	낭
낮	낮
낯	낯
낰	낰
낱	낱
낲	낲
낳	낳
내	내
낵	낵
낶	낶
낷	낷
낸	낸
낹	낹
낺	낺
낻	낻
낼	낼
낽	낽
낾	낾
낿	낿
냀	냀
냁	냁
냂	냂
냃	냃
냄	냄
냅	냅
냆	냆
냇	냇
냈	냈
냉	냉
냊	냊
냋	냋
냌	냌
냍	냍
냎	냎
냏	냏
냐	냐
냑	냑
냒	냒
냓	냓
냔	냔
냕	냕
냖	냖
냗	냗
냘	냘
냙	냙
냚	냚
냛	냛
냜	냜
냝	냝
냞	냞
냟	냟
냠	냠
냡	냡
냢	냢
냣	냣
냤	냤
냥	냥
냦	냦
냧	냧
냨	냨
냩	냩
냪	냪
냫	냫
냬	냬
냭	냭
냮	냮
냯	냯
냰	냰
냱	냱
냲	냲
냳	냳
냴	냴
냵	냵
냶	냶
냷	냷
냸	냸
냹	냹
냺	냺
냻	냻
냼	냼
냽	냽
냾	냾
냿	냿
넀	넀
넁	넁
넂	넂
넃	넃
넄	넄
넅	넅
넆	넆
넇	넇
너	너
넉	넉
넊	넊
넋	넋
넌	넌
넍	넍
넎	넎
넏	넏
널	널
넑	넑
넒	넒
넓	넓
넔	넔
넕	넕
넖	넖
넗	넗
넘	넘
넙	넙
넚	넚
넛	넛
넜	넜
넝	넝
넞	넞
넟	넟
넠	넠
넡	넡
넢	넢
넣	넣
네	네
넥	넥
넦	넦
넧	넧
넨	넨
넩	넩
넪	넪
넫	넫
넬	넬
넭	넭
넮	넮
넯	넯
넰	넰
넱	넱
넲	넲
넳	넳
넴	넴
넵	넵
넶	넶
넷	넷
넸	넸
넹	넹
넺	넺
넻	넻
넼	넼
넽	넽
넾	넾
넿	넿
녀	녀
녁	녁
녂	녂
녃	녃
년	년
녅	녅
녆	녆
녇	녇
녈	녈
녉	녉
녊	녊
녋	녋
녌	녌
녍	녍
녎	녎
녏	녏
념	념
녑	녑
녒	녒
녓	녓
녔	녔
녕	녕
녖	녖
녗	녗
녘	녘
녙	녙
녚	녚
녛	녛
녜	녜
녝	녝
녞	녞
녟	녟
녠	녠
녡	녡
녢	녢
녣	녣
녤	녤
녥	녥
녦	녦
녧	녧
녨	녨
녩	녩
녪	녪
녫	녫
녬	녬
녭	녭
녮	녮
녯	녯
녰	녰
녱	녱
녲	녲
녳	녳
녴	녴
녵	녵
녶	녶
녷	녷
노	노
녹	녹
녺	녺
녻	녻
논	논
녽	녽
녾	녾
녿	녿
놀	놀
놁	놁
놂	놂
놃	놃
놄	놄
놅	놅
놆	놆
놇	놇
놈	놈
놉	놉
놊	놊
놋	놋
놌	놌
농	농
놎	놎
놏	놏
놐	놐
놑	놑
높	높
놓	놓
놔	놔
놕	놕
놖	놖
놗	놗
놘	놘
놙	놙
놚	놚
놛	놛
놜	놜
놝	놝
놞	놞
놟	놟
놠	놠
놡	놡
놢	놢
놣	놣
놤	놤
놥	놥
놦	놦
놧	놧
놨	놨
놩	놩
놪	놪
놫	놫
놬	놬
놭	놭
놮	놮
놯	놯
놰	놰
놱	놱
놲	놲
놳	놳
놴	놴
놵	놵
놶	놶
놷	놷
놸	놸
놹	놹
놺	놺
놻	놻
놼	놼
놽	놽
놾	놾
놿	놿
뇀	뇀
뇁	뇁
뇂	뇂
뇃	뇃
뇄	뇄
뇅	뇅
뇆	뇆
뇇	뇇
뇈	뇈
뇉	뇉
뇊	뇊
뇋	뇋
뇌	뇌
뇍	뇍
뇎	뇎
뇏	뇏
뇐	뇐
뇑	뇑
뇒	뇒
뇓	뇓
뇔	뇔
뇕	뇕
뇖	뇖
뇗	뇗
뇘	뇘
뇙	뇙
뇚	뇚
뇛	뇛
뇜	뇜
뇝	뇝
뇞	뇞
뇟	뇟
뇠	뇠
뇡	뇡
뇢	뇢
뇣	뇣
뇤	뇤
뇥	뇥
뇦	뇦
뇧	뇧
뇨	뇨
뇩	뇩
뇪	뇪
뇫	뇫
뇬	뇬
뇭	뇭
뇮	뇮
뇯	뇯
뇰	뇰
뇱	뇱
뇲	뇲
뇳	뇳
뇴	뇴
뇵	뇵
뇶	뇶
뇷	뇷
뇸	뇸
뇹	뇹
뇺	뇺
뇻	뇻
뇼	뇼
뇽	뇽
뇾	뇾
뇿	뇿
눀	눀
눁	눁
눂	눂
눃	눃
누	누
눅	눅
눆	눆
눇	눇
눈	눈
눉	눉
눊	눊
눋	눋
눌	눌
눍	눍
눎	눎
눏	눏
눐	눐
눑	눑
눒	눒
눓	눓
눔	눔
눕	눕
눖	눖
눗	눗
눘	눘
눙	눙
눚	눚
눛	눛
눜	눜
눝	눝
눞	눞
눟	눟
눠	눠
눡	눡
눢	눢
눣	눣
눤	눤
눥	눥
눦	눦
눧	눧
눨	눨
눩	눩
눪	눪
눫	눫
눬	눬
눭	눭
눮	눮
눯	눯
눰	눰
눱	눱
눲	눲
눳	눳
눴	눴
눵	눵
눶	눶
눷	눷
눸	눸
눹	눹
눺	눺
눻	눻
눼	눼
눽	눽
눾	눾
눿	눿
뉀	뉀
뉁	뉁
뉂	뉂
뉃	뉃
뉄	뉄
뉅	뉅
뉆	뉆
뉇	뉇
뉈	뉈
뉉	뉉
뉊	뉊
뉋	뉋
뉌	뉌
뉍	뉍
뉎	뉎
뉏	뉏
뉐	뉐
뉑	뉑
뉒	뉒
뉓	뉓
뉔	뉔
뉕	뉕
뉖	뉖
뉗	뉗
뉘	뉘
뉙	뉙
뉚	뉚
뉛	뉛
뉜	뉜
뉝	뉝
뉞	뉞
뉟	뉟
뉠	뉠
뉡	뉡
뉢	뉢
뉣	뉣
뉤	뉤
뉥	뉥
뉦	뉦
뉧	뉧
뉨	뉨
뉩	뉩
뉪	뉪
뉫	뉫
뉬	뉬
뉭	뉭
뉮	뉮
뉯	뉯
뉰	뉰
뉱	뉱
뉲	뉲
뉳	뉳
뉴	뉴
뉵	뉵
뉶	뉶
뉷	뉷
뉸	뉸
뉹	뉹
뉺	뉺
뉻	뉻
뉼	뉼
뉽	뉽
뉾	뉾
뉿	뉿
늀	늀
늁	늁
늂	늂
늃	늃
늄	늄
늅	늅
늆	늆
늇	늇
늈	늈
늉	늉
늊	늊
늋	늋
늌	늌
늍	늍
늎	늎
늏	늏
느	느
늑	늑
늒	늒
늓	늓
는	는
늕	늕
늖	늖
늗	늗
늘	늘
늙	늙
늚	늚
늛	늛
늜	늜
늝	늝
늞	늞
늟	늟
늠	늠
늡	늡
늢	늢
늣	늣
늤	늤
능	능
늦	늦
늧	늧
늨	늨
늩	늩
늪	늪
늫	늫
늬	늬
늭	늭
늮	늮
늯	늯
늰	늰
늱	늱
늲	늲
늳	늳
늴	늴
늵	늵
늶	늶
늷	늷
늸	늸
늹	늹
늺	늺
늻	늻
늼	늼
늽	늽
늾	늾
늿	늿
닀	닀
닁	닁
닂	닂
닃	닃
닄	닄
닅	닅
닆	닆
닇	닇
니	니
닉	닉
닊	닊
닋	닋
닌	닌
닍	닍
닎	닎
닏	닏
닐	닐
닑	닑
닒	닒
닓	닓
닔	닔
닕	닕
닖	닖
닗	닗
님	님
닙	닙
닚	닚
닛	닛
닜	닜
닝	닝
닞	닞
닟	닟
닠	닠
닡	닡
닢	닢
닣	닣
다	다
닥	닥
닦	닦
닧	닧
단	단
닩	닩
닪	닪
닫	닫
달	달
닭	닭
닮	닮
닯	닯
닰	닰
닱	닱
닲	닲
닳	닳
담	담
답	답
닶	닶
닷	닷
닸	닸
당	당
닺	닺
닻	닻
닼	닼
닽	닽
닾	닾
닿	닿
대	대
댁	댁
댂	댂
댃	댃
댄	댄
댅	댅
댆	댆
댇	댇
댈	댈
댉	댉
댊	댊
댋	댋
댌	댌
댍	댍
댎	댎
댏	댏
댐	댐
댑	댑
댒	댒
댓	댓
댔	댔
댕	댕
댖	댖
댗	댗
댘	댘
댙	댙
댚	댚
댛	댛
댜	댜
댝	댝
댞	댞
댟	댟
댠	댠
댡	댡
댢	댢
댣	댣
댤	댤
댥	댥
댦	댦
댧	댧
댨	댨
댩	댩
댪	댪
댫	댫
댬	댬
댭	댭
댮	댮
댯	댯
댰	댰
댱	댱
댲	댲
댳	댳
댴	댴
댵	댵
댶	댶
댷	댷
댸	댸
댹	댹
댺	댺
댻	댻
댼	댼
댽	댽
댾	댾
댿	댿
덀	덀
덁	덁
덂	덂
덃	덃
덄	덄
덅	덅
덆	덆
덇	덇
덈	덈
덉	덉
덊	덊
덋	덋
덌	덌
덍	덍
덎	덎
덏	덏
덐	덐
덑	덑
덒	덒
덓	덓
더	더
덕	덕
덖	덖
덗	덗
던	던
덙	덙
덚	덚
덛	덛
덜	덜
덝	덝
덞	덞
덟	덟
덠	덠
덡	덡
덢	덢
덣	덣
덤	덤
덥	덥
덦	덦
덧	덧
덨	덨
덩	덩
덪	덪
덫	덫
덬	덬
덭	덭
덮	덮
덯	덯
데	데
덱	덱
덲	덲
덳	덳
덴	덴
덵	덵
덶	덶
덷	덷
델	델
덹	덹
덺	덺
덻	덻
덼	덼
덽	덽
덾	덾
덿	덿
뎀	뎀
뎁	뎁
뎂	뎂
뎃	뎃
뎄	뎄
뎅	뎅
뎆	뎆
뎇	뎇
뎈	뎈
뎉	뎉
뎊	뎊
뎋	뎋
뎌	뎌
뎍	뎍
뎎	뎎
뎏	뎏
뎐	뎐
뎑	뎑
뎒	뎒
뎓	뎓
뎔	뎔
뎕	뎕
뎖	뎖
뎗	뎗
뎘	뎘
뎙	뎙
뎚	뎚
뎛	뎛
뎜	뎜
뎝	뎝
뎞	뎞
뎟	뎟
뎠	뎠
뎡	뎡
뎢	뎢
뎣	뎣
뎤	뎤
뎥	뎥
뎦	뎦
뎧	뎧
뎨	뎨
뎩	뎩
뎪	뎪
뎫	뎫
뎬	뎬
뎭	뎭
뎮	뎮
뎯	뎯
뎰	뎰
뎱	뎱
뎲	뎲
뎳	뎳
뎴	뎴
뎵	뎵
뎶	뎶
뎷	뎷
뎸	뎸
뎹	뎹
뎺	뎺
뎻	뎻
뎼	뎼
뎽	뎽
뎾	뎾
뎿	뎿
돀	돀
돁	돁
돂	돂
돃	돃
도	도
독	독
돆	돆
돇	돇
돈	돈
돉	돉
돊	돊
돋	돋
돌	돌
돍	돍
돎	돎
돏	돏
돐	돐
돑	돑
돒	돒
돓	돓
돔	돔
돕	돕
돖	돖
돗	돗
돘	돘
동	동
돚	돚
돛	돛
돜	돜
돝	돝
돞	돞
돟	돟
돠	돠
돡	돡
돢	돢
돣	돣
돤	돤
돥	돥
돦	돦
돧	돧
돨	돨
돩	돩
돪	돪
돫	돫
돬	돬
돭	돭
돮	돮
돯	돯
돰	돰
돱	돱
돲	돲
돳	돳
돴	돴
돵	돵
돶	돶
돷	돷
돸	돸
돹	돹
돺	돺
돻	돻
돼	돼
돽	돽
돾	돾
돿	돿
됀	됀
됁	됁
됂	됂
됃	됃
됄	됄
됅	됅
됆	됆
됇	됇
됈	됈
됉	됉
됊	됊
됋	됋
됌	됌
됍	됍
됎	됎
됏	됏
됐	됐
됑	됑
됒	됒
됓	됓
됔	됔
됕	됕
됖	됖
됗	됗
되	되
됙	됙
됚	됚
됛	됛
된	된
됝	됝
됞	됞
됟	됟
될	될
됡	됡
됢	됢
됣	됣
됤	됤
됥	됥
됦	됦
됧	됧
됨	됨
됩	됩
됪	됪
됫	됫
됬	됬
됭	됭
됮	됮
됯	됯
됰	됰
됱	됱
됲	됲
됳	됳
됴	됴
됵	됵
됶	됶
됷	됷
됸	됸
됹	됹
됺	됺
됻	됻
됼	됼
됽	됽
됾	됾
됿	됿
둀	둀
둁	둁
둂	둂
둃	둃
둄	둄
둅	둅
둆	둆
둇	둇
둈	둈
둉	둉
둊	둊
둋	둋
둌	둌
둍	둍
둎	둎
둏	둏
두	두
둑	둑
둒	둒
둓	둓
둔	둔
둕	둕
둖	둖
둗	둗
둘	둘
둙	둙
둚	둚
둛	둛
둜	둜
둝	둝
둞	둞
둟	둟
둠	둠
둡	둡
둢	둢
둣	둣
둤	둤
둥	둥
둦	둦
둧	둧
둨	둨
둩	둩
둪	둪
둫	둫
둬	둬
둭	둭
둮	둮
둯	둯
둰	둰
둱	둱
둲	둲
둳	둳
둴	둴
둵	둵
둶	둶
둷	둷
둸	둸
둹	둹
둺	둺
둻	둻
둼	둼
둽	둽
둾	둾
둿	둿
뒀	뒀
뒁	뒁
뒂	뒂
뒃	뒃
뒄	뒄
뒅	뒅
뒆	뒆
뒇	뒇
뒈	뒈
뒉	뒉
뒊	뒊
뒋	뒋
뒌	뒌
뒍	뒍
뒎	뒎
뒏	뒏
뒐	뒐
뒑	뒑
뒒	뒒
뒓	뒓
뒔	뒔
뒕	뒕
뒖	뒖
뒗	뒗
뒘	뒘
뒙	뒙
뒚	뒚
뒛	뒛
뒜	뒜
뒝	뒝
뒞	뒞
뒟	뒟
뒠	뒠
뒡	뒡
뒢	뒢
뒣	뒣
뒤	뒤
뒥	뒥
뒦	뒦
뒧	뒧
뒨	뒨
뒩	뒩
뒪	뒪
뒫	뒫
뒬	뒬
뒭	뒭
뒮	뒮
뒯	뒯
뒰	뒰
뒱	뒱
뒲	뒲
뒳	뒳
뒴	뒴
뒵	뒵
뒶	뒶
뒷	뒷
뒸	뒸
뒹	뒹
뒺	뒺
뒻	뒻
뒼	뒼
뒽	뒽
뒾	뒾
뒿	뒿
듀	듀
듁	듁
듂	듂
듃	듃
듄	듄
듅	듅
듆	듆
듇	듇
듈	듈
듉	듉
듊	듊
듋	듋
듌	듌
듍	듍
듎	듎
듏	듏
듐	듐
듑	듑
듒	듒
듓	듓
듔	듔
듕	듕
듖	듖
듗	듗
듘	듘
듙	듙
듚	듚
듛	듛
드	드
득	득
듞	듞
듟	듟
든	든
듡	듡
듢	듢
듣	듣
들	들
듥	듥
듦	듦
듧	듧
듨	듨
듩	듩
듪	듪
듫	듫
듬	듬
듭	듭
듮	듮
듯	듯
듰	듰
등	등
듲	듲
듳	듳
듴	듴
듵	듵
듶	듶
듷	듷
듸	듸
듹	듹
듺	듺
듻	듻
듼	듼
듽	듽
듾	듾
듿	듿
딀	딀
딁	딁
딂	딂
딃	딃
딄	딄
딅	딅
딆	딆
딇	딇
딈	딈
딉	딉
딊	딊
딋	딋
딌	딌
딍	딍
딎	딎
딏	딏
딐	딐
딑	딑
딒	딒
딓	딓
디	디
딕	딕
딖	딖
딗	딗
딘	딘
딙	딙
딚	딚
딛	딛
딜	딜
딝	딝
딞	딞
딟	딟
딠	딠
딡	딡
딢	딢
딣	딣
딤	딤
딥	딥
딦	딦
딧	딧
딨	딨
딩	딩
딪	딪
딫	딫
딬	딬
딭	딭
딮	딮
딯	딯
따	따
딱	딱
딲	딲
딳	딳
딴	딴
딵	딵
딶	딶
딷	딷
딸	딸
딹	딹
딺	딺
딻	딻
딼	딼
딽	딽
딾	딾
딿	딿
땀	땀
땁	땁
땂	땂
땃	땃
땄	땄
땅	땅
땆	땆
땇	땇
땈	땈
땉	땉
땊	땊
땋	땋
때	때
땍	땍
땎	땎
땏	땏
땐	땐
땑	땑
땒	땒
땓	땓
땔	땔
땕	땕
땖	땖
땗	땗
땘	땘
땙	땙
땚	땚
땛	땛
땜	땜
땝	땝
땞	땞
땟	땟
땠	땠
땡	땡
땢	땢
땣	땣
땤	땤
땥	땥
땦	땦
땧	땧
땨	땨
땩	땩
땪	땪
땫	땫
땬	땬
땭	땭
땮	땮
땯	땯
땰	땰
땱	땱
땲	땲
땳	땳
땴	땴
땵	땵
땶	땶
땷	땷
땸	땸
땹	땹
땺	땺
땻	땻
땼	땼
땽	땽
땾	땾
땿	땿
떀	떀
떁	떁
떂	떂
떃	떃
떄	떄
떅	떅
떆	떆
떇	떇
떈	떈
떉	떉
떊	떊
떋	떋
떌	떌
떍	떍
떎	떎
떏	떏
떐	떐
떑	떑
떒	떒
떓	떓
떔	떔
떕	떕
떖	떖
떗	떗
떘	떘
떙	떙
떚	떚
떛	떛
떜	떜
떝	떝
떞	떞
떟	떟
떠	떠
떡	떡
떢	떢
떣	떣
떤	떤
떥	떥
떦	떦
떧	떧
떨	떨
떩	떩
떪	떪
떫	떫
떬	떬
떭	떭
떮	떮
떯	떯
떰	떰
떱	떱
떲	떲
떳	떳
떴	떴
떵	떵
떶	떶
떷	떷
떸	떸
떹	떹
떺	떺
떻	떻
떼	떼
떽	떽
떾	떾
떿	떿
뗀	뗀
뗁	뗁
뗂	뗂
뗃	뗃
뗄	뗄
뗅	뗅
뗆	뗆
뗇	뗇
뗈	뗈
뗉	뗉
뗊	뗊
뗋	뗋
뗌	뗌
뗍	뗍
뗎	뗎
뗏	뗏
뗐	뗐
뗑	뗑
뗒	뗒
뗓	뗓
뗔	뗔
뗕	뗕
뗖	뗖
뗗	뗗
뗘	뗘
뗙	뗙
뗚	뗚
뗛	뗛
뗜	뗜
뗝	뗝
뗞	뗞
뗟	뗟
뗠	뗠
뗡	뗡
뗢	뗢
뗣	뗣
뗤	뗤
뗥	뗥
뗦	뗦
뗧	뗧
뗨	뗨
뗩	뗩
뗪	뗪
뗫	뗫
뗬	뗬
뗭	뗭
뗮	뗮
뗯	뗯
뗰	뗰
뗱	뗱
뗲	뗲
뗳	뗳
뗴	뗴
뗵	뗵
뗶	뗶
뗷	뗷
뗸	뗸
뗹	뗹
뗺	뗺
뗻	뗻
뗼	뗼
뗽	뗽
뗾	뗾
뗿	뗿
똀	똀
똁	똁
똂	똂
똃	똃
똄	똄
똅	똅
똆	똆
똇	똇
똈	똈
똉	똉
똊	똊
똋	똋
똌	똌
똍	똍
똎	똎
똏	똏
또	또
똑	똑
똒	똒
똓	똓
똔	똔
똕	똕
똖	똖
똗	똗
똘	똘
똙	똙
똚	똚
똛	똛
똜	똜
똝	똝
똞	똞
똟	똟
똠	똠
똡	똡
똢	똢
똣	똣
똤	똤
똥	똥
똦	똦
똧	똧
똨	똨
똩	똩
똪	똪
똫	똫
똬	똬
똭	똭
똮	똮
똯	똯
똰	똰
똱	똱
똲	똲
똳	똳
똴	똴
똵	똵
똶	똶
똷	똷
똸	똸
똹	똹
똺	똺
똻	똻
똼	똼
똽	똽
똾	똾
똿	똿
뙀	뙀
뙁	뙁
뙂	뙂
뙃	뙃
뙄	뙄
뙅	뙅
뙆	뙆
뙇	뙇
뙈	뙈
뙉	뙉
뙊	뙊
뙋	뙋
뙌	뙌
뙍	뙍
뙎	뙎
뙏	뙏
뙐	뙐
뙑	뙑
뙒	뙒
뙓	뙓
뙔	뙔
뙕	뙕
뙖	뙖
뙗	뙗
뙘	뙘
뙙	뙙
뙚	뙚
뙛	뙛
뙜	뙜
뙝	뙝
뙞	뙞
뙟	뙟
뙠	뙠
뙡	뙡
뙢	뙢
뙣	뙣
뙤	뙤
뙥	뙥
뙦	뙦
뙧	뙧
뙨	뙨
뙩	뙩
뙪	뙪
뙫	뙫
뙬	뙬
뙭	뙭
뙮	뙮
뙯	뙯
뙰	뙰
뙱	뙱
뙲	뙲
뙳	뙳
뙴	뙴
뙵	뙵
뙶	뙶
뙷	뙷
뙸	뙸
뙹	뙹
뙺	뙺
뙻	뙻
뙼	뙼
뙽	뙽
뙾	뙾
뙿	뙿
뚀	뚀
뚁	뚁
뚂	뚂
뚃	뚃
뚄	뚄
뚅	뚅
뚆	뚆
뚇	뚇
뚈	뚈
뚉	뚉
뚊	뚊
뚋	뚋
뚌	뚌
뚍	뚍
뚎	뚎
뚏	뚏
뚐	뚐
뚑	뚑
뚒	뚒
뚓	뚓
뚔	뚔
뚕	뚕
뚖	뚖
뚗	뚗
뚘	뚘
뚙	뚙
뚚	뚚
뚛	뚛
뚜	뚜
뚝	뚝
뚞	뚞
뚟	뚟
뚠	뚠
뚡	뚡
뚢	뚢
뚣	뚣
뚤	뚤
뚥	뚥
뚦	뚦
뚧	뚧
뚨	뚨
뚩	뚩
뚪	뚪
뚫	뚫
뚬	뚬
뚭	뚭
뚮	뚮
뚯	뚯
뚰	뚰
뚱	뚱
뚲	뚲
뚳	뚳
뚴	뚴
뚵	뚵
뚶	뚶
뚷	뚷
뚸	뚸
뚹	뚹
뚺	뚺
뚻	뚻
뚼	뚼
뚽	뚽
뚾	뚾
뚿	뚿
뛀	뛀
뛁	뛁
뛂	뛂
뛃	뛃
뛄	뛄
뛅	뛅
뛆	뛆
뛇	뛇
뛈	뛈
뛉	뛉
뛊	뛊
뛋	뛋
뛌	뛌
뛍	뛍
뛎	뛎
뛏	뛏
뛐	뛐
뛑	뛑
뛒	뛒
뛓	뛓
뛔	뛔
뛕	뛕
뛖	뛖
뛗	뛗
뛘	뛘
뛙	뛙
뛚	뛚
뛛	뛛
뛜	뛜
뛝	뛝
뛞	뛞
뛟	뛟
뛠	뛠
뛡	뛡
뛢	뛢
뛣	뛣
뛤	뛤
뛥	뛥
뛦	뛦
뛧	뛧
뛨	뛨
뛩	뛩
뛪	뛪
뛫	뛫
뛬	뛬
뛭	뛭
뛮	뛮
뛯	뛯
뛰	뛰
뛱	뛱
뛲	뛲
뛳	뛳
뛴	뛴
뛵	뛵
뛶	뛶
뛷	뛷
뛸	뛸
뛹	뛹
뛺	뛺
뛻	뛻
뛼	뛼
뛽	뛽
뛾	뛾
뛿	뛿
뜀	뜀
뜁	뜁
뜂	뜂
뜃	뜃
뜄	뜄
뜅	뜅
뜆	뜆
뜇	뜇
뜈	뜈
뜉	뜉
뜊	뜊
뜋	뜋
뜌	뜌
뜍	뜍
뜎	뜎
뜏	뜏
뜐	뜐
뜑	뜑
뜒	뜒
뜓	뜓
뜔	뜔
뜕	뜕
뜖	뜖
뜗	뜗
뜘	뜘
뜙	뜙
뜚	뜚
뜛	뜛
뜜	뜜
뜝	뜝
뜞	뜞
뜟	뜟
뜠	뜠
뜡	뜡
뜢	뜢
뜣	뜣
뜤	뜤
뜥	뜥
뜦	뜦
뜧	뜧
뜨	뜨
뜩	뜩
뜪	뜪
뜫	뜫
뜬	뜬
뜭	뜭
뜮	뜮
뜯	뜯
뜰	뜰
뜱	뜱
뜲	뜲
뜳	뜳
뜴	뜴
뜵	뜵
뜶	뜶
뜷	뜷
뜸	뜸
뜹	뜹
뜺	뜺
뜻	뜻
뜼	뜼
뜽	뜽
뜾	뜾
뜿	뜿
띀	띀
띁	띁
띂	띂
띃	띃
띄	띄
띅	띅
띆	띆
띇	띇
띈	띈
띉	띉
띊	띊
띋	띋
띌	띌
띍	띍
띎	띎
띏	띏
띐	띐
띑	띑
띒	띒
띓	띓
띔	띔
띕	띕
띖	띖
띗	띗
띘	띘
띙	띙
띚	띚
띛	띛
띜	띜
띝	띝
띞	띞
띟	띟
띠	띠
띡	띡
띢	띢
띣	띣
띤	띤
띥	띥
띦	띦
띧	띧
띨	띨
띩	띩
띪	띪
띫	띫
띬	띬
띭	띭
띮	띮
띯	띯
띰	띰
띱	띱
띲	띲
띳	띳
띴	띴
띵	띵
띶	띶
띷	띷
띸	띸
띹	띹
띺	띺
띻	띻
라	라
락	락
띾	띾
띿	띿
란	란
랁	랁
랂	랂
랃	랃
랄	랄
랅	랅
랆	랆
랇	랇
랈	랈
랉	랉
랊	랊
랋	랋
람	람
랍	랍
랎	랎
랏	랏
랐	랐
랑	랑
랒	랒
랓	랓
랔	랔
랕	랕
랖	랖
랗	랗
래	래
랙	랙
랚	랚
랛	랛
랜	랜
랝	랝
랞	랞
랟	랟
랠	랠
랡	랡
랢	랢
랣	랣
랤	랤
랥	랥
랦	랦
랧	랧
램	램
랩	랩
랪	랪
랫	랫
랬	랬
랭	랭
랮	랮
랯	랯
랰	랰
랱	랱
랲	랲
랳	랳
랴	랴
략	략
랶	랶
랷	랷
랸	랸
랹	랹
랺	랺
랻	랻
랼	랼
랽	랽
랾	랾
랿	랿
럀	럀
럁	럁
럂	럂
럃	럃
럄	럄
럅	럅
럆	럆
럇	럇
럈	럈
량	량
럊	럊
럋	럋
럌	럌
럍	럍
럎	럎
럏	럏
럐	럐
럑	럑
럒	럒
럓	럓
럔	럔
럕	럕
럖	럖
럗	럗
럘	럘
럙	럙
럚	럚
럛	럛
럜	럜
럝	럝
럞	럞
럟	럟
럠	럠
럡	럡
럢	럢
럣	럣
럤	럤
럥	럥
럦	럦
럧	럧
럨	럨
럩	럩
럪	럪
럫	럫
러	러
럭	럭
럮	럮
럯	럯
런	런
럱	럱
럲	럲
럳	럳
럴	럴
럵	럵
럶	럶
럷	럷
럸	럸
럹	럹
럺	럺
럻	럻
럼	럼
럽	럽
럾	럾
럿	럿
렀	렀
렁	렁
렂	렂
렃	렃
렄	렄
렅	렅
렆	렆
렇	렇
레	레
렉	렉
렊	렊
렋	렋
렌	렌
렍	렍
렎	렎
렏	렏
렐	렐
렑	렑
렒	렒
렓	렓
렔	렔
렕	렕
렖	렖
렗	렗
렘	렘
렙	렙
렚	렚
렛	렛
렜	렜
렝	렝
렞	렞
렟	렟
렠	렠
렡	렡
렢	렢
렣	렣
려	려
력	력
렦	렦
렧	렧
련	련
렩	렩
렪	렪
렫	렫
렬	렬
렭	렭
렮	렮
렯	렯
렰	렰
렱	렱
렲	렲
렳	렳
렴	렴
렵	렵
렶	렶
렷	렷
렸	렸
령	령
렺	렺
렻	렻
렼	렼
렽	렽
렾	렾
렿	렿
례	례
롁	롁
롂	롂
롃	롃
롄	롄
롅	롅
롆	롆
롇	롇
롈	롈
롉	롉
롊	롊
롋	롋
롌	롌
롍	롍
롎	롎
롏	롏
롐	롐
롑	롑
롒	롒
롓	롓
롔	롔
롕	롕
롖	롖
롗	롗
롘	롘
롙	롙
롚	롚
롛	롛
로	로
록	록
롞	롞
롟	롟
론	론
롡	롡
롢	롢
롣	롣
롤	롤
롥	롥
롦	롦
롧	롧
롨	롨
롩	롩
롪	롪
롫	롫
롬	롬
롭	롭
롮	롮
롯	롯
롰	롰
롱	롱
롲	롲
롳	롳
롴	롴
롵	롵
롶	롶
롷	롷
롸	롸
롹	롹
롺	롺
롻	롻
롼	롼
롽	롽
롾	롾
롿	롿
뢀	뢀
뢁	뢁
뢂	뢂
뢃	뢃
뢄	뢄
뢅	뢅
뢆	뢆
뢇	뢇
뢈	뢈
뢉	뢉
뢊	뢊
뢋	뢋
뢌	뢌
뢍	뢍
뢎	뢎
뢏	뢏
뢐	뢐
뢑	뢑
뢒	뢒
뢓	뢓
뢔	뢔
뢕	뢕
뢖	뢖
뢗	뢗
뢘	뢘
뢙	뢙
뢚	뢚
뢛	뢛
뢜	뢜
뢝	뢝
뢞	뢞
뢟	뢟
뢠	뢠
뢡	뢡
뢢	뢢
뢣	뢣
뢤	뢤
뢥	뢥
뢦	뢦
뢧	뢧
뢨	뢨
뢩	뢩
뢪	뢪
뢫	뢫
뢬	뢬
뢭	뢭
뢮	뢮
뢯	뢯
뢰	뢰
뢱	뢱
뢲	뢲
뢳	뢳
뢴	뢴
뢵	뢵
뢶	뢶
뢷	뢷
뢸	뢸
뢹	뢹
뢺	뢺
뢻	뢻
뢼	뢼
뢽	뢽
뢾	뢾
뢿	뢿
룀	룀
룁	룁
룂	룂
룃	룃
룄	룄
룅	룅
룆	룆
룇	룇
룈	룈
룉	룉
룊	룊
룋	룋
료	료
룍	룍
룎	룎
룏	룏
룐	룐
룑	룑
룒	룒
룓	룓
룔	룔
룕	룕
룖	룖
룗	룗
룘	룘
룙	룙
룚	룚
룛	룛
룜	룜
룝	룝
룞	룞
룟	룟
룠	룠
룡	룡
룢	룢
룣	룣
룤	룤
룥	룥
룦	룦
룧	룧
루	루
룩	룩
룪	룪
룫	룫
룬	룬
룭	룭
룮	룮
룯	룯
룰	룰
룱	룱
룲	룲
룳	룳
룴	룴
룵	룵
룶	룶
룷	룷
룸	룸
룹	룹
룺	룺
룻	룻
룼	룼
룽	룽
룾	룾
룿	룿
뤀	뤀
뤁	뤁
뤂	뤂
뤃	뤃
뤄	뤄
뤅	뤅
뤆	뤆
뤇	뤇
뤈	뤈
뤉	뤉
뤊	뤊
뤋	뤋
뤌	뤌
뤍	뤍
뤎	뤎
뤏	뤏
뤐	뤐
뤑	뤑
뤒	뤒
뤓	뤓
뤔	뤔
뤕	뤕
뤖	뤖
뤗	뤗
뤘	뤘
뤙	뤙
뤚	뤚
뤛	뤛
뤜	뤜
뤝	뤝
뤞	뤞
뤟	뤟
뤠	뤠
뤡	뤡
뤢	뤢
뤣	뤣
뤤	뤤
뤥	뤥
뤦	뤦
뤧	뤧
뤨	뤨
뤩	뤩
뤪	뤪
뤫	뤫
뤬	뤬
뤭	뤭
뤮	뤮
뤯	뤯
뤰	뤰
뤱	뤱
뤲	뤲
뤳	뤳
뤴	뤴
뤵	뤵
뤶	뤶
뤷	뤷
뤸	뤸
뤹	뤹
뤺	뤺
뤻	뤻
뤼	뤼
뤽	뤽
뤾	뤾
뤿	뤿
륀	륀
륁	륁
륂	륂
륃	륃
륄	륄
륅	륅
륆	륆
륇	륇
륈	륈
륉	륉
륊	륊
륋	륋
륌	륌
륍	륍
륎	륎
륏	륏
륐	륐
륑	륑
륒	륒
륓	륓
륔	륔
륕	륕
륖	륖
륗	륗
류	류
륙	륙
륚	륚
륛	륛
륜	륜
륝	륝
륞	륞
륟	륟
률	률
륡	륡
륢	륢
륣	륣
륤	륤
륥	륥
륦	륦
륧	륧
륨	륨
륩	륩
륪	륪
륫	륫
륬	륬
륭	륭
륮	륮
륯	륯
륰	륰
륱	륱
륲	륲
륳	륳
르	르
륵	륵
륶	륶
륷	륷
른	른
륹	륹
륺	륺
륻	륻
를	를
륽	륽
륾	륾
륿	륿
릀	릀
릁	릁
릂	릂
릃	릃
름	름
릅	릅
릆	릆
릇	릇
릈	릈
릉	릉
릊	릊
릋	릋
릌	릌
릍	릍
릎	릎
릏	릏
릐	릐
릑	릑
릒	릒
릓	릓
릔	릔
릕	릕
릖	릖
릗	릗
릘	릘
릙	릙
릚	릚
릛	릛
릜	릜
릝	릝
릞	릞
릟	릟
릠	릠
릡	릡
릢	릢
릣	릣
릤	릤
릥	릥
릦	릦
릧	릧
릨	릨
릩	릩
릪	릪
릫	릫
리	리
릭	릭
릮	릮
릯	릯
린	린
릱	릱
릲	릲
릳	릳
릴	릴
릵	릵
릶	릶
릷	릷
릸	릸
릹	릹
릺	릺
릻	릻
림	림
립	립
릾	릾
릿	릿
맀	맀
링	링
맂	맂
맃	맃
맄	맄
맅	맅
맆	맆
맇	맇
마	마
막	막
맊	맊
맋	맋
만	만
맍	맍
많	많
맏	맏
말	말
맑	맑
맒	맒
맓	맓
맔	맔
맕	맕
맖	맖
맗	맗
맘	맘
맙	맙
맚	맚
맛	맛
맜	맜
망	망
맞	맞
맟	맟
맠	맠
맡	맡
맢	맢
맣	맣
매	매
맥	맥
맦	맦
맧	맧
맨	맨
맩	맩
맪	맪
맫	맫
맬	맬
맭	맭
맮	맮
맯	맯
맰	맰
맱	맱
맲	맲
맳	맳
맴	맴
맵	맵
맶	맶
맷	맷
맸	맸
맹	맹
맺	맺
맻	맻
맼	맼
맽	맽
맾	맾
맿	맿
먀	먀
먁	먁
먂	먂
먃	먃
먄	먄
먅	먅
먆	먆
먇	먇
먈	먈
먉	먉
먊	먊
먋	먋
먌	먌
먍	먍
먎	먎
먏	먏
먐	먐
먑	먑
먒	먒
먓	먓
먔	먔
먕	먕
먖	먖
먗	먗
먘	먘
먙	먙
먚	먚
먛	먛
먜	먜
먝	먝
먞	먞
먟	먟
먠	먠
먡	먡
먢	먢
먣	먣
먤	먤
먥	먥
먦	먦
먧	먧
먨	먨
먩	먩
먪	먪
먫	먫
먬	먬
먭	먭
먮	먮
먯	먯
먰	먰
먱	먱
먲	먲
먳	먳
먴	먴
먵	먵
먶	먶
먷	먷
머	머
먹	먹
먺	먺
먻	먻
먼	먼
먽	먽
먾	먾
먿	먿
멀	멀
멁	멁
멂	멂
멃	멃
멄	멄
멅	멅
멆	멆
멇	멇
멈	멈
멉	멉
멊	멊
멋	멋
멌	멌
멍	멍
멎	멎
멏	멏
멐	멐
멑	멑
멒	멒
멓	멓
메	메
멕	멕
멖	멖
멗	멗
멘	멘
멙	멙
멚	멚
멛	멛
멜	멜
멝	멝
멞	멞
멟	멟
멠	멠
멡	멡
멢	멢
멣	멣
멤	멤
멥	멥
멦	멦
멧	멧
멨	멨
멩	멩
멪	멪
멫	멫
멬	멬
멭	멭
멮	멮
멯	멯
며	며
멱	멱
멲	멲
멳	멳
면	면
멵	멵
멶	멶
멷	멷
멸	멸
멹	멹
멺	멺
멻	멻
멼	멼
멽	멽
멾	멾
멿	멿
몀	몀
몁	몁
몂	몂
몃	몃
몄	몄
명	명
몆	몆
몇	몇
몈	몈
몉	몉
몊	몊
몋	몋
몌	몌
몍	몍
몎	몎
몏	몏
몐	몐
몑	몑
몒	몒
몓	몓
몔	몔
몕	몕
몖	몖
몗	몗
몘	몘
몙	몙
몚	몚
몛	몛
몜	몜
몝	몝
몞	몞
몟	몟
몠	몠
몡	몡
몢	몢
몣	몣
몤	몤
몥	몥
몦	몦
몧	몧
모	모
목	목
몪	몪
몫	몫
몬	몬
몭	몭
몮	몮
몯	몯
몰	몰
몱	몱
몲	몲
몳	몳
몴	몴
몵	몵
몶	몶
몷	몷
몸	몸
몹	몹
몺	몺
못	못
몼	몼
몽	몽
몾	몾
몿	몿
뫀	뫀
뫁	뫁
뫂	뫂
뫃	뫃
뫄	뫄
뫅	뫅
뫆	뫆
뫇	뫇
뫈	뫈
뫉	뫉
뫊	뫊
뫋	뫋
뫌	뫌
뫍	뫍
뫎	뫎
뫏	뫏
뫐	뫐
뫑	뫑
뫒	뫒
뫓	뫓
뫔	뫔
뫕	뫕
뫖	뫖
뫗	뫗
뫘	뫘
뫙	뫙
뫚	뫚
뫛	뫛
뫜	뫜
뫝	뫝
뫞	뫞
뫟	뫟
뫠	뫠
뫡	뫡
뫢	뫢
뫣	뫣
뫤	뫤
뫥	뫥
뫦	뫦
뫧	뫧
뫨	뫨
뫩	뫩
뫪	뫪
뫫	뫫
뫬	뫬
뫭	뫭
뫮	뫮
뫯	뫯
뫰	뫰
뫱	뫱
뫲	뫲
뫳	뫳
뫴	뫴
뫵	뫵
뫶	뫶
뫷	뫷
뫸	뫸
뫹	뫹
뫺	뫺
뫻	뫻
뫼	뫼
뫽	뫽
뫾	뫾
뫿	뫿
묀	묀
묁	묁
묂	묂
묃	묃
묄	묄
묅	묅
묆	묆
묇	묇
묈	묈
묉	묉
묊	묊
묋	묋
묌	묌
묍	묍
묎	묎
묏	묏
묐	묐
묑	묑
묒	묒
묓	묓
묔	묔
묕	묕
묖	묖
묗	묗
묘	묘
묙	묙
묚	묚
묛	묛
묜	묜
묝	묝
묞	묞
묟	묟
묠	묠
묡	묡
묢	묢
묣	묣
묤	묤
묥	묥
묦	묦
묧	묧
묨	묨
묩	묩
묪	묪
묫	묫
묬	묬
묭	묭
묮	묮
묯	묯
묰	묰
묱	묱
묲	묲
묳	묳
무	무
묵	묵
묶	묶
묷	묷
문	문
묹	묹
묺	묺
묻	묻
물	물
묽	묽
묾	묾
묿	묿
뭀	뭀
뭁	뭁
뭂	뭂
뭃	뭃
뭄	뭄
뭅	뭅
뭆	뭆
뭇	뭇
뭈	뭈
뭉	뭉
뭊	뭊
뭋	뭋
뭌	뭌
뭍	뭍
뭎	뭎
뭏	뭏
뭐	뭐
뭑	뭑
뭒	뭒
뭓	뭓
뭔	뭔
뭕	뭕
뭖	뭖
뭗	뭗
뭘	뭘
뭙	뭙
뭚	뭚
뭛	뭛
뭜	뭜
뭝	뭝
뭞	뭞
뭟	뭟
뭠	뭠
뭡	뭡
뭢	뭢
뭣	뭣
뭤	뭤
뭥	뭥
뭦	뭦
뭧	뭧
뭨	뭨
뭩	뭩
뭪	뭪
뭫	뭫
뭬	뭬
뭭	뭭
뭮	뭮
뭯	뭯
뭰	뭰
뭱	뭱
뭲	뭲
뭳	뭳
뭴	뭴
뭵	뭵
뭶	뭶
뭷	뭷
뭸	뭸
뭹	뭹
뭺	뭺
뭻	뭻
뭼	뭼
뭽	뭽
뭾	뭾
뭿	뭿
뮀	뮀
뮁	뮁
뮂	뮂
뮃	뮃
뮄	뮄
뮅	뮅
뮆	뮆
뮇	뮇
뮈	뮈
뮉	뮉
뮊	뮊
뮋	뮋
뮌	뮌
뮍	뮍
뮎	뮎
뮏	뮏
뮐	뮐
뮑	뮑
뮒	뮒
뮓	뮓
뮔	뮔
뮕	뮕
뮖	뮖
뮗	뮗
뮘	뮘
뮙	뮙
뮚	뮚
뮛	뮛
뮜	뮜
뮝	뮝
뮞	뮞
뮟	뮟
뮠	뮠
뮡	뮡
뮢	뮢
뮣	뮣
뮤	뮤
뮥	뮥
뮦	뮦
뮧	뮧
뮨	뮨
뮩	뮩
뮪	뮪
뮫	뮫
뮬	뮬
뮭	뮭
뮮	뮮
뮯	뮯
뮰	뮰
뮱	뮱
뮲	뮲
뮳	뮳
뮴	뮴
뮵	뮵
뮶	뮶
뮷	뮷
뮸	뮸
뮹	뮹
뮺	뮺
뮻	뮻
뮼	뮼
뮽	뮽
뮾	뮾
뮿	뮿
므	므
믁	믁
믂	믂
믃	믃
믄	믄
믅	믅
믆	믆
믇	믇
믈	믈
믉	믉
믊	믊
믋	믋
믌	믌
믍	믍
믎	믎
믏	믏
믐	믐
믑	믑
믒	믒
믓	믓
믔	믔
믕	믕
믖	믖
믗	믗
믘	믘
믙	믙
믚	믚
믛	믛
믜	믜
믝	믝
믞	믞
믟	믟
믠	믠
믡	믡
믢	믢
믣	믣
믤	믤
믥	믥
믦	믦
믧	믧
믨	믨
믩	믩
믪	믪
믫	믫
믬	믬
믭	믭
믮	믮
믯	믯
믰	믰
믱	믱
믲	믲
믳	믳
믴	믴
믵	믵
믶	믶
믷	믷
미	미
믹	믹
믺	믺
믻	믻
민	민
믽	믽
믾	믾
믿	믿
밀	밀
밁	밁
밂	밂
밃	밃
밄	밄
밅	밅
밆	밆
밇	밇
밈	밈
밉	밉
밊	밊
밋	밋
밌	밌
밍	밍
밎	밎
및	및
밐	밐
밑	밑
밒	밒
밓	밓
바	바
박	박
밖	밖
밗	밗
반	반
밙	밙
밚	밚
받	받
발	발
밝	밝
밞	밞
밟	밟
밠	밠
밡	밡
밢	밢
밣	밣
밤	밤
밥	밥
밦	밦
밧	밧
밨	밨
방	방
밪	밪
밫	밫
밬	밬
밭	밭
밮	밮
밯	밯
배	배
백	백
밲	밲
밳	밳
밴	밴
밵	밵
밶	밶
밷	밷
밸	밸
밹	밹
밺	밺
밻	밻
밼	밼
밽	밽
밾	밾
밿	밿
뱀	뱀
뱁	뱁
뱂	뱂
뱃	뱃
뱄	뱄
뱅	뱅
뱆	뱆
뱇	뱇
뱈	뱈
뱉	뱉
뱊	뱊
뱋	뱋
뱌	뱌
뱍	뱍
뱎	뱎
뱏	뱏
뱐	뱐
뱑	뱑
뱒	뱒
뱓	뱓
뱔	뱔
뱕	뱕
뱖	뱖
뱗	뱗
뱘	뱘
뱙	뱙
뱚	뱚
뱛	뱛
뱜	뱜
뱝	뱝
뱞	뱞
뱟	뱟
뱠	뱠
뱡	뱡
뱢	뱢
뱣	뱣
뱤	뱤
뱥	뱥
뱦	뱦
뱧	뱧
뱨	뱨
뱩	뱩
뱪	뱪
뱫	뱫
뱬	뱬
뱭	뱭
뱮	뱮
뱯	뱯
뱰	뱰
뱱	뱱
뱲	뱲
뱳	뱳
뱴	뱴
뱵	뱵
뱶	뱶
뱷	뱷
뱸	뱸
뱹	뱹
뱺	뱺
뱻	뱻
뱼	뱼
뱽	뱽
뱾	뱾
뱿	뱿
벀	벀
벁	벁
벂	벂
벃	벃
버	버
벅	벅
벆	벆
벇	벇
번	번
벉	벉
벊	벊
벋	벋
벌	벌
벍	벍
벎	벎
벏	벏
벐	벐
벑	벑
벒	벒
벓	벓
범	범
법	법
벖	벖
벗	벗
벘	벘
벙	벙
벚	벚
벛	벛
벜	벜
벝	벝
벞	벞
벟	벟
베	베
벡	벡
벢	벢
벣	벣
벤	벤
벥	벥
벦	벦
벧	벧
벨	벨
벩	벩
벪	벪
벫	벫
벬	벬
벭	벭
벮	벮
벯	벯
벰	벰
벱	벱
벲	벲
벳	벳
벴	벴
벵	벵
벶	벶
벷	벷
벸	벸
벹	벹
벺	벺
벻	벻
벼	벼
벽	벽
벾	벾
벿	벿
변	변
볁	볁
볂	볂
볃	볃
별	별
볅	볅
볆	볆
볇	볇
볈	볈
볉	볉
볊	볊
볋	볋
볌	볌
볍	볍
볎	볎
볏	볏
볐	볐
병	병
볒	볒
볓	볓
볔	볔
볕	볕
볖	볖
볗	볗
볘	볘
볙	볙
볚	볚
볛	볛
볜	볜
볝	볝
볞	볞
볟	볟
볠	볠
볡	볡
볢	볢
볣	볣
볤	볤
볥	볥
볦	볦
볧	볧
볨	볨
볩	볩
볪	볪
볫	볫
볬	볬
볭	볭
볮	볮
볯	볯
볰	볰
볱	볱
볲	볲
볳	볳
보	보
복	복
볶	볶
볷	볷
본	본
볹	볹
볺	볺
볻	볻
볼	볼
볽	볽
볾	볾
볿	볿
봀	봀
봁	봁
봂	봂
봃	봃
봄	봄
봅	봅
봆	봆
봇	봇
봈	봈
봉	봉
봊	봊
봋	봋
봌	봌
봍	봍
봎	봎
봏	봏
봐	봐
봑	봑
봒	봒
봓	봓
봔	봔
봕	봕
봖	봖
봗	봗
봘	봘
봙	봙
봚	봚
봛	봛
봜	봜
봝	봝
봞	봞
봟	봟
봠	봠
봡	봡
봢	봢
봣	봣
봤	봤
봥	봥
봦	봦
봧	봧
봨	봨
봩	봩
봪	봪
봫	봫
봬	봬
봭	봭
봮	봮
봯	봯
봰	봰
봱	봱
봲	봲
봳	봳
봴	봴
봵	봵
봶	봶
봷	봷
봸	봸
봹	봹
봺	봺
봻	봻
봼	봼
봽	봽
봾	봾
봿	봿
뵀	뵀
뵁	뵁
뵂	뵂
뵃	뵃
뵄	뵄
뵅	뵅
뵆	뵆
뵇	뵇
뵈	뵈
뵉	뵉
뵊	뵊
뵋	뵋
뵌	뵌
뵍	뵍
뵎	뵎
뵏	뵏
뵐	뵐
뵑	뵑
뵒	뵒
뵓	뵓
뵔	뵔
뵕	뵕
뵖	뵖
뵗	뵗
뵘	뵘
뵙	뵙
뵚	뵚
뵛	뵛
뵜	뵜
뵝	뵝
뵞	뵞
뵟	뵟
뵠	뵠
뵡	뵡
뵢	뵢
뵣	뵣
뵤	뵤
뵥	뵥
뵦	뵦
뵧	뵧
뵨	뵨
뵩	뵩
뵪	뵪
뵫	뵫
뵬	뵬
뵭	뵭
뵮	뵮
뵯	뵯
뵰	뵰
뵱	뵱
뵲	뵲
뵳	뵳
뵴	뵴
뵵	뵵
뵶	뵶
뵷	뵷
뵸	뵸
뵹	뵹
뵺	뵺
뵻	뵻
뵼	뵼
뵽	뵽
뵾	뵾
뵿	뵿
부	부
북	북
붂	붂
붃	붃
분	분
붅	붅
붆	붆
붇	붇
불	불
붉	붉
붊	붊
붋	붋
붌	붌
붍	붍
붎	붎
붏	붏
붐	붐
붑	붑
붒	붒
붓	붓
붔	붔
붕	붕
붖	붖
붗	붗
붘	붘
붙	붙
붚	붚
붛	붛
붜	붜
붝	붝
붞	붞
붟	붟
붠	붠
붡	붡
붢	붢
붣	붣
붤	붤
붥	붥
붦	붦
붧	붧
붨	붨
붩	붩
붪	붪
붫	붫
붬	붬
붭	붭
붮	붮
붯	붯
붰	붰
붱	붱
붲	붲
붳	붳
붴	붴
붵	붵
붶	붶
붷	붷
붸	붸
붹	붹
붺	붺
붻	붻
붼	붼
붽	붽
붾	붾
붿	붿
뷀	뷀
뷁	뷁
뷂	뷂
뷃	뷃
뷄	뷄
뷅	뷅
뷆	뷆
뷇	뷇
뷈	뷈
뷉	뷉
뷊	뷊
뷋	뷋
뷌	뷌
뷍	뷍
뷎	뷎
뷏	뷏
뷐	뷐
뷑	뷑
뷒	뷒
뷓	뷓
뷔	뷔
뷕	뷕
뷖	뷖
뷗	뷗
뷘	뷘
뷙	뷙
뷚	뷚
뷛	뷛
뷜	뷜
뷝	뷝
뷞	뷞
뷟	뷟
뷠	뷠
뷡	뷡
뷢	뷢
뷣	뷣
뷤	뷤
뷥	뷥
뷦	뷦
뷧	뷧
뷨	뷨
뷩	뷩
뷪	뷪
뷫	뷫
뷬	뷬
뷭	뷭
뷮	뷮
뷯	뷯
뷰	뷰
뷱	뷱
뷲	뷲
뷳	뷳
뷴	뷴
뷵	뷵
뷶	뷶
뷷	뷷
뷸	뷸
뷹	뷹
뷺	뷺
뷻	뷻
뷼	뷼
뷽	뷽
뷾	뷾
뷿	뷿
븀	븀
븁	븁
븂	븂
븃	븃
븄	븄
븅	븅
븆	븆
븇	븇
븈	븈
븉	븉
븊	븊
븋	븋
브	브
븍	븍
븎	븎
븏	븏
븐	븐
븑	븑
븒	븒
븓	븓
블	블
븕	븕
븖	븖
븗	븗
븘	븘
븙	븙
븚	븚
븛	븛
븜	븜
븝	븝
븞	븞
븟	븟
븠	븠
븡	븡
븢	븢
븣	븣
븤	븤
븥	븥
븦	븦
븧	븧
븨	븨
븩	븩
븪	븪
븫	븫
븬	븬
븭	븭
븮	븮
븯	븯
븰	븰
븱	븱
븲	븲
븳	븳
븴	븴
븵	븵
븶	븶
븷	븷
븸	븸
븹	븹
븺	븺
븻	븻
븼	븼
븽	븽
븾	븾
븿	븿
빀	빀
빁	빁
빂	빂
빃	빃
비	비
빅	빅
빆	빆
빇	빇
빈	빈
빉	빉
빊	빊
빋	빋
빌	빌
빍	빍
빎	빎
빏	빏
빐	빐
빑	빑
빒	빒
빓	빓
빔	빔
빕	빕
빖	빖
빗	빗
빘	빘
빙	빙
빚	빚
빛	빛
빜	빜
빝	빝
빞	빞
빟	빟
빠	빠
빡	빡
빢	빢
빣	빣
빤	빤
빥	빥
빦	빦
빧	빧
빨	빨
빩	빩
빪	빪
빫	빫
빬	빬
빭	빭
빮	빮
빯	빯
빰	빰
빱	빱
빲	빲
빳	빳
빴	빴
빵	빵
빶	빶
빷	빷
빸	빸
빹	빹
빺	빺
빻	빻
빼	빼
빽	빽
빾	빾
빿	빿
뺀	뺀
뺁	뺁
뺂	뺂
뺃	뺃
뺄	뺄
뺅	뺅
뺆	뺆
뺇	뺇
뺈	뺈
뺉	뺉
뺊	뺊
뺋	뺋
뺌	뺌
뺍	뺍
뺎	뺎
뺏	뺏
뺐	뺐
뺑	뺑
뺒	뺒
뺓	뺓
뺔	뺔
뺕	뺕
뺖	뺖
뺗	뺗
뺘	뺘
뺙	뺙
뺚	뺚
뺛	뺛
뺜	뺜
뺝	뺝
뺞	뺞
뺟	뺟
뺠	뺠
뺡	뺡
뺢	뺢
뺣	뺣
뺤	뺤
뺥	뺥
뺦	뺦
뺧	뺧
뺨	뺨
뺩	뺩
뺪	뺪
뺫	뺫
뺬	뺬
뺭	뺭
뺮	뺮
뺯	뺯
뺰	뺰
뺱	뺱
뺲	뺲
뺳	뺳
뺴	뺴
뺵	뺵
뺶	뺶
뺷	뺷
뺸	뺸
뺹	뺹
뺺	뺺
뺻	뺻
뺼	뺼
뺽	뺽
뺾	뺾
뺿	뺿
뻀	뻀
뻁	뻁
뻂	뻂
뻃	뻃
뻄	뻄
뻅	뻅
뻆	뻆
뻇	뻇
뻈	뻈
뻉	뻉
뻊	뻊
뻋	뻋
뻌	뻌
뻍	뻍
뻎	뻎
뻏	뻏
뻐	뻐
뻑	뻑
뻒	뻒
뻓	뻓
뻔	뻔
뻕	뻕
뻖	뻖
뻗	뻗
뻘	뻘
뻙	뻙
뻚	뻚
뻛	뻛
뻜	뻜
뻝	뻝
뻞	뻞
뻟	뻟
뻠	뻠
뻡	뻡
뻢	뻢
뻣	뻣
뻤	뻤
뻥	뻥
뻦	뻦
뻧	뻧
뻨	뻨
뻩	뻩
뻪	뻪
뻫	뻫
뻬	뻬
뻭	뻭
뻮	뻮
뻯	뻯
뻰	뻰
뻱	뻱
뻲	뻲
뻳	뻳
뻴	뻴
뻵	뻵
뻶	뻶
뻷	뻷
뻸	뻸
뻹	뻹
뻺	뻺
뻻	뻻
뻼	뻼
뻽	뻽
뻾	뻾
뻿	뻿
뼀	뼀
뼁	뼁
뼂	뼂
뼃	뼃
뼄	뼄
뼅	뼅
뼆	뼆
뼇	뼇
뼈	뼈
뼉	뼉
뼊	뼊
뼋	뼋
뼌	뼌
뼍	뼍
뼎	뼎
뼏	뼏
뼐	뼐
뼑	뼑
뼒	뼒
뼓	뼓
뼔	뼔
뼕	뼕
뼖	뼖
뼗	뼗
뼘	뼘
뼙	뼙
뼚	뼚
뼛	뼛
뼜	뼜
뼝	뼝
뼞	뼞
뼟	뼟
뼠	뼠
뼡	뼡
뼢	뼢
뼣	뼣
뼤	뼤
뼥	뼥
뼦	뼦
뼧	뼧
뼨	뼨
뼩	뼩
뼪	뼪
뼫	뼫
뼬	뼬
뼭	뼭
뼮	뼮
뼯	뼯
뼰	뼰
뼱	뼱
뼲	뼲
뼳	뼳
뼴	뼴
뼵	뼵
뼶	뼶
뼷	뼷
뼸	뼸
뼹	뼹
뼺	뼺
뼻	뼻
뼼	뼼
뼽	뼽
뼾	뼾
뼿	뼿
뽀	뽀
뽁	뽁
뽂	뽂
뽃	뽃
뽄	뽄
뽅	뽅
뽆	뽆
뽇	뽇
뽈	뽈
뽉	뽉
뽊	뽊
뽋	뽋
뽌	뽌
뽍	뽍
뽎	뽎
뽏	뽏
뽐	뽐
뽑	뽑
뽒	뽒
뽓	뽓
뽔	뽔
뽕	뽕
뽖	뽖
뽗	뽗
뽘	뽘
뽙	뽙
뽚	뽚
뽛	뽛
뽜	뽜
뽝	뽝
뽞	뽞
뽟	뽟
뽠	뽠
뽡	뽡
뽢	뽢
뽣	뽣
뽤	뽤
뽥	뽥
뽦	뽦
뽧	뽧
뽨	뽨
뽩	뽩
뽪	뽪
뽫	뽫
뽬	뽬
뽭	뽭
뽮	뽮
뽯	뽯
뽰	뽰
뽱	뽱
뽲	뽲
뽳	뽳
뽴	뽴
뽵	뽵
뽶	뽶
뽷	뽷
뽸	뽸
뽹	뽹
뽺	뽺
뽻	뽻
뽼	뽼
뽽	뽽
뽾	뽾
뽿	뽿
뾀	뾀
뾁	뾁
뾂	뾂
뾃	뾃
뾄	뾄
뾅	뾅
뾆	뾆
뾇	뾇
뾈	뾈
뾉	뾉
뾊	뾊
뾋	뾋
뾌	뾌
뾍	뾍
뾎	뾎
뾏	뾏
뾐	뾐
뾑	뾑
뾒	뾒
뾓	뾓
뾔	뾔
뾕	뾕
뾖	뾖
뾗	뾗
뾘	뾘
뾙	뾙
뾚	뾚
뾛	뾛
뾜	뾜
뾝	뾝
뾞	뾞
뾟	뾟
뾠	뾠
뾡	뾡
뾢	뾢
뾣	뾣
뾤	뾤
뾥	뾥
뾦	뾦
뾧	뾧
뾨	뾨
뾩	뾩
뾪	뾪
뾫	뾫
뾬	뾬
뾭	뾭
뾮	뾮
뾯	뾯
뾰	뾰
뾱	뾱
뾲	뾲
뾳	뾳
뾴	뾴
뾵	뾵
뾶	뾶
뾷	뾷
뾸	뾸
뾹	뾹
뾺	뾺
뾻	뾻
뾼	뾼
뾽	뾽
뾾	뾾
뾿	뾿
뿀	뿀
뿁	뿁
뿂	뿂
뿃	뿃
뿄	뿄
뿅	뿅
뿆	뿆
뿇	뿇
뿈	뿈
뿉	뿉
뿊	뿊
뿋	뿋
뿌	뿌
뿍	뿍
뿎	뿎
뿏	뿏
뿐	뿐
뿑	뿑
뿒	뿒
뿓	뿓
뿔	뿔
뿕	뿕
뿖	뿖
뿗	뿗
뿘	뿘
뿙	뿙
뿚	뿚
뿛	뿛
뿜	뿜
뿝	뿝
뿞	뿞
뿟	뿟
뿠	뿠
뿡	뿡
뿢	뿢
뿣	뿣
뿤	뿤
뿥	뿥
뿦	뿦
뿧	뿧
뿨	뿨
뿩	뿩
뿪	뿪
뿫	뿫
뿬	뿬
뿭	뿭
뿮	뿮
뿯	뿯
뿰	뿰
뿱	뿱
뿲	뿲
뿳	뿳
뿴	뿴
뿵	뿵
뿶	뿶
뿷	뿷
뿸	뿸
뿹	뿹
뿺	뿺
뿻	뿻
뿼	뿼
뿽	뿽
뿾	뿾
뿿	뿿
쀀	쀀
쀁	쀁
쀂	쀂
쀃	쀃
쀄	쀄
쀅	쀅
쀆	쀆
쀇	쀇
쀈	쀈
쀉	쀉
쀊	쀊
쀋	쀋
쀌	쀌
쀍	쀍
쀎	쀎
쀏	쀏
쀐	쀐
쀑	쀑
쀒	쀒
쀓	쀓
쀔	쀔
쀕	쀕
쀖	쀖
쀗	쀗
쀘	쀘
쀙	쀙
쀚	쀚
쀛	쀛
쀜	쀜
쀝	쀝
쀞	쀞
쀟	쀟
쀠	쀠
쀡	쀡
쀢	쀢
쀣	쀣
쀤	쀤
쀥	쀥
쀦	쀦
쀧	쀧
쀨	쀨
쀩	쀩
쀪	쀪
쀫	쀫
쀬	쀬
쀭	쀭
쀮	쀮
쀯	쀯
쀰	쀰
쀱	쀱
쀲	쀲
쀳	쀳
쀴	쀴
쀵	쀵
쀶	쀶
쀷	쀷
쀸	쀸
쀹	쀹
쀺	쀺
쀻	쀻
쀼	쀼
쀽	쀽
쀾	쀾
쀿	쀿
쁀	쁀
쁁	쁁
쁂	쁂
쁃	쁃
쁄	쁄
쁅	쁅
쁆	쁆
쁇	쁇
쁈	쁈
쁉	쁉
쁊	쁊
쁋	쁋
쁌	쁌
쁍	쁍
쁎	쁎
쁏	쁏
쁐	쁐
쁑	쁑
쁒	쁒
쁓	쁓
쁔	쁔
쁕	쁕
쁖	쁖
쁗	쁗
쁘	쁘
쁙	쁙
쁚	쁚
쁛	쁛
쁜	쁜
쁝	쁝
쁞	쁞
쁟	쁟
쁠	쁠
쁡	쁡
쁢	쁢
쁣	쁣
쁤	쁤
쁥	쁥
쁦	쁦
쁧	쁧
쁨	쁨
쁩	쁩
쁪	쁪
쁫	쁫
쁬	쁬
쁭	쁭
쁮	쁮
쁯	쁯
쁰	쁰
쁱	쁱
쁲	쁲
쁳	쁳
쁴	쁴
쁵	쁵
쁶	쁶
쁷	쁷
쁸	쁸
쁹	쁹
쁺	쁺
쁻	쁻
쁼	쁼
쁽	쁽
쁾	쁾
쁿	쁿
삀	삀
삁	삁
삂	삂
삃	삃
삄	삄
삅	삅
삆	삆
삇	삇
삈	삈
삉	삉
삊	삊
삋	삋
삌	삌
삍	삍
삎	삎
삏	삏
삐	삐
삑	삑
삒	삒
삓	삓
삔	삔
삕	삕
삖	삖
삗	삗
삘	삘
삙	삙
삚	삚
삛	삛
삜	삜
삝	삝
삞	삞
삟	삟
삠	삠
삡	삡
삢	삢
삣	삣
삤	삤
삥	삥
삦	삦
삧	삧
삨	삨
삩	삩
삪	삪
삫	삫
사	사
삭	삭
삮	삮
삯	삯
산	산
삱	삱
삲	삲
삳	삳
살	살
삵	삵
삶	삶
삷	삷
삸	삸
삹	삹
삺	삺
삻	삻
삼	삼
삽	삽
삾	삾
삿	삿
샀	샀
상	상
샂	샂
샃	샃
샄	샄
샅	샅
샆	샆
샇	샇
새	새
색	색
샊	샊
샋	샋
샌	샌
샍	샍
샎	샎
샏	샏
샐	샐
샑	샑
샒	샒
샓	샓
샔	샔
샕	샕
샖	샖
샗	샗
샘	샘
샙	샙
샚	샚
샛	샛
샜	샜
생	생
샞	샞
샟	샟
샠	샠
샡	샡
샢	샢
샣	샣
샤	샤
샥	샥
샦	샦
샧	샧
샨	샨
샩	샩
샪	샪
샫	샫
샬	샬
샭	샭
샮	샮
샯	샯
샰	샰
샱	샱
샲	샲
샳	샳
샴	샴
샵	샵
샶	샶
샷	샷
샸	샸
샹	샹
샺	샺
샻	샻
샼	샼
샽	샽
샾	샾
샿	샿
섀	섀
섁	섁
섂	섂
섃	섃
섄	섄
섅	섅
섆	섆
섇	섇
섈	섈
섉	섉
섊	섊
섋	섋
섌	섌
섍	섍
섎	섎
섏	섏
섐	섐
섑	섑
섒	섒
섓	섓
섔	섔
섕	섕
섖	섖
섗	섗
섘	섘
섙	섙
섚	섚
섛	섛
서	서
석	석
섞	섞
섟	섟
선	선
섡	섡
섢	섢
섣	섣
설	설
섥	섥
섦	섦
섧	섧
섨	섨
섩	섩
섪	섪
섫	섫
섬	섬
섭	섭
섮	섮
섯	섯
섰	섰
성	성
섲	섲
섳	섳
섴	섴
섵	섵
섶	섶
섷	섷
세	세
섹	섹
섺	섺
섻	섻
센	센
섽	섽
섾	섾
섿	섿
셀	셀
셁	셁
셂	셂
셃	셃
셄	셄
셅	셅
셆	셆
셇	셇
셈	셈
셉	셉
셊	셊
셋	셋
셌	셌
셍	셍
셎	셎
셏	셏
셐	셐
셑	셑
셒	셒
셓	셓
셔	셔
셕	셕
셖	셖
셗	셗
션	션
셙	셙
셚	셚
셛	셛
셜	셜
셝	셝
셞	셞
셟	셟
셠	셠
셡	셡
셢	셢
셣	셣
셤	셤
셥	셥
셦	셦
셧	셧
셨	셨
셩	셩
셪	셪
셫	셫
셬	셬
셭	셭
셮	셮
셯	셯
셰	셰
셱	셱
셲	셲
셳	셳
셴	셴
셵	셵
셶	셶
셷	셷
셸	셸
셹	셹
셺	셺
셻	셻
셼	셼
셽	셽
셾	셾
셿	셿
솀	솀
솁	솁
솂	솂
솃	솃
솄	솄
솅	솅
솆	솆
솇	솇
솈	솈
솉	솉
솊	솊
솋	솋
소	소
속	속
솎	솎
솏	솏
손	손
솑	솑
솒	솒
솓	솓
솔	솔
솕	솕
솖	솖
솗	솗
솘	솘
솙	솙
솚	솚
솛	솛
솜	솜
솝	솝
솞	솞
솟	솟
솠	솠
송	송
솢	솢
솣	솣
솤	솤
솥	솥
솦	솦
솧	솧
솨	솨
솩	솩
솪	솪
솫	솫
솬	솬
솭	솭
솮	솮
솯	솯
솰	솰
솱	솱
솲	솲
솳	솳
솴	솴
솵	솵
솶	솶
솷	솷
솸	솸
솹	솹
솺	솺
솻	솻
솼	솼
솽	솽
솾	솾
솿	솿
쇀	쇀
쇁	쇁
쇂	쇂
쇃	쇃
쇄	쇄
쇅	쇅
쇆	쇆
쇇	쇇
쇈	쇈
쇉	쇉
쇊	쇊
쇋	쇋
쇌	쇌
쇍	쇍
쇎	쇎
쇏	쇏
쇐	쇐
쇑	쇑
쇒	쇒
쇓	쇓
쇔	쇔
쇕	쇕
쇖	쇖
쇗	쇗
쇘	쇘
쇙	쇙
쇚	쇚
쇛	쇛
쇜	쇜
쇝	쇝
쇞	쇞
쇟	쇟
쇠	쇠
쇡	쇡
쇢	쇢
쇣	쇣
쇤	쇤
쇥	쇥
쇦	쇦
쇧	쇧
쇨	쇨
쇩	쇩
쇪	쇪
쇫	쇫
쇬	쇬
쇭	쇭
쇮	쇮
쇯	쇯
쇰	쇰
쇱	쇱
쇲	쇲
쇳	쇳
쇴	쇴
쇵	쇵
쇶	쇶
쇷	쇷
쇸	쇸
쇹	쇹
쇺	쇺
쇻	쇻
쇼	쇼
쇽	쇽
쇾	쇾
쇿	쇿
숀	숀
숁	숁
숂	숂
숃	숃
숄	숄
숅	숅
숆	숆
숇	숇
숈	숈
숉	숉
숊	숊
숋	숋
숌	숌
숍	숍
숎	숎
숏	숏
숐	숐
숑	숑
숒	숒
숓	숓
숔	숔
숕	숕
숖	숖
숗	숗
수	수
숙	숙
숚	숚
숛	숛
순	순
숝	숝
숞	숞
숟	숟
술	술
숡	숡
숢	숢
숣	숣
숤	숤
숥	숥
숦	숦
숧	숧
숨	숨
숩	숩
숪	숪
숫	숫
숬	숬
숭	숭
숮	숮
숯	숯
숰	숰
숱	숱
숲	숲
숳	숳
숴	숴
숵	숵
숶	숶
숷	숷
숸	숸
숹	숹
숺	숺
숻	숻
숼	숼
숽	숽
숾	숾
숿	숿
쉀	쉀
쉁	쉁
쉂	쉂
쉃	쉃
쉄	쉄
쉅	쉅
쉆	쉆
쉇	쉇
쉈	쉈
쉉	쉉
쉊	쉊
쉋	쉋
쉌	쉌
쉍	쉍
쉎	쉎
쉏	쉏
쉐	쉐
쉑	쉑
쉒	쉒
쉓	쉓
쉔	쉔
쉕	쉕
쉖	쉖
쉗	쉗
쉘	쉘
쉙	쉙
쉚	쉚
쉛	쉛
쉜	쉜
쉝	쉝
쉞	쉞
쉟	쉟
쉠	쉠
쉡	쉡
쉢	쉢
쉣	쉣
쉤	쉤
쉥	쉥
쉦	쉦
쉧	쉧
쉨	쉨
쉩	쉩
쉪	쉪
쉫	쉫
쉬	쉬
쉭	쉭
쉮	쉮
쉯	쉯
쉰	쉰
쉱	쉱
쉲	쉲
쉳	쉳
쉴	쉴
쉵	쉵
쉶	쉶
쉷	쉷
쉸	쉸
쉹	쉹
쉺	쉺
쉻	쉻
쉼	쉼
쉽	쉽
쉾	쉾
쉿	쉿
슀	슀
슁	슁
슂	슂
슃	슃
슄	슄
슅	슅
슆	슆
슇	슇
슈	슈
슉	슉
슊	슊
슋	슋
슌	슌
슍	슍
슎	슎
슏	슏
슐	슐
슑	슑
슒	슒
슓	슓
슔	슔
슕	슕
슖	슖
슗	슗
슘	슘
슙	슙
슚	슚
슛	슛
슜	슜
슝	슝
슞	슞
슟	슟
슠	슠
슡	슡
슢	슢
슣	슣
스	스
슥	슥
슦	슦
슧	슧
슨	슨
슩	슩
슪	슪
슫	슫
슬	슬
슭	슭
슮	슮
슯	슯
슰	슰
슱	슱
슲	슲
슳	슳
슴	슴
습	습
슶	슶
슷	슷
슸	슸
승	승
슺	슺
슻	슻
슼	슼
슽	슽
슾	슾
슿	슿
싀	싀
싁	싁
싂	싂
싃	싃
싄	싄
싅	싅
싆	싆
싇	싇
싈	싈
싉	싉
싊	싊
싋	싋
싌	싌
싍	싍
싎	싎
싏	싏
싐	싐
싑	싑
싒	싒
싓	싓
싔	싔
싕	싕
싖	싖
싗	싗
싘	싘
싙	싙
싚	싚
싛	싛
시	시
식	식
싞	싞
싟	싟
신	신
싡	싡
싢	싢
싣	싣
실	실
싥	싥
싦	싦
싧	싧
싨	싨
싩	싩
싪	싪
싫	싫
심	심
십	십
싮	싮
싯	싯
싰	싰
싱	싱
싲	싲
싳	싳
싴	싴
싵	싵
싶	싶
싷	싷
싸	싸
싹	싹
싺	싺
싻	싻
싼	싼
싽	싽
싾	싾
싿	싿
쌀	쌀
쌁	쌁
쌂	쌂
쌃	쌃
쌄	쌄
쌅	쌅
쌆	쌆
쌇	쌇
쌈	쌈
쌉	쌉
쌊	쌊
쌋	쌋
쌌	쌌
쌍	쌍
쌎	쌎
쌏	쌏
쌐	쌐
쌑	쌑
쌒	쌒
쌓	쌓
쌔	쌔
쌕	쌕
쌖	쌖
쌗	쌗
쌘	쌘
쌙	쌙
쌚	쌚
쌛	쌛
쌜	쌜
쌝	쌝
쌞	쌞
쌟	쌟
쌠	쌠
쌡	쌡
쌢	쌢
쌣	쌣
쌤	쌤
쌥	쌥
쌦	쌦
쌧	쌧
쌨	쌨
쌩	쌩
쌪	쌪
쌫	쌫
쌬	쌬
쌭	쌭
쌮	쌮
쌯	쌯
쌰	쌰
쌱	쌱
쌲	쌲
쌳	쌳
쌴	쌴
쌵	쌵
쌶	쌶
쌷	쌷
쌸	쌸
쌹	쌹
쌺	쌺
쌻	쌻
쌼	쌼
쌽	쌽
쌾	쌾
쌿	쌿
썀	썀
썁	썁
썂	썂
썃	썃
썄	썄
썅	썅
썆	썆
썇	썇
썈	썈
썉	썉
썊	썊
썋	썋
썌	썌
썍	썍
썎	썎
썏	썏
썐	썐
썑	썑
썒	썒
썓	썓
썔	썔
썕	썕
썖	썖
썗	썗
썘	썘
썙	썙
썚	썚
썛	썛
썜	썜
썝	썝
썞	썞
썟	썟
썠	썠
썡	썡
썢	썢
썣	썣
썤	썤
썥	썥
썦	썦
썧	썧
써	써
썩	썩
썪	썪
썫	썫
썬	썬
썭	썭
썮	썮
썯	썯
썰	썰
썱	썱
썲	썲
썳	썳
썴	썴
썵	썵
썶	썶
썷	썷
썸	썸
썹	썹
썺	썺
썻	썻
썼	썼
썽	썽
썾	썾
썿	썿
쎀	쎀
쎁	쎁
쎂	쎂
쎃	쎃
쎄	쎄
쎅	쎅
쎆	쎆
쎇	쎇
쎈	쎈
쎉	쎉
쎊	쎊
쎋	쎋
쎌	쎌
쎍	쎍
쎎	쎎
쎏	쎏
쎐	쎐
쎑	쎑
쎒	쎒
쎓	쎓
쎔	쎔
쎕	쎕
쎖	쎖
쎗	쎗
쎘	쎘
쎙	쎙
쎚	쎚
쎛	쎛
쎜	쎜
쎝	쎝
쎞	쎞
쎟	쎟
쎠	쎠
쎡	쎡
쎢	쎢
쎣	쎣
쎤	쎤
쎥	쎥
쎦	쎦
쎧	쎧
쎨	쎨
쎩	쎩
쎪	쎪
쎫	쎫
쎬	쎬
쎭	쎭
쎮	쎮
쎯	쎯
쎰	쎰
쎱	쎱
쎲	쎲
쎳	쎳
쎴	쎴
쎵	쎵
쎶	쎶
쎷	쎷
쎸	쎸
쎹	쎹
쎺	쎺
쎻	쎻
쎼	쎼
쎽	쎽
쎾	쎾
쎿	쎿
쏀	쏀
쏁	쏁
쏂	쏂
쏃	쏃
쏄	쏄
쏅	쏅
쏆	쏆
쏇	쏇
쏈	쏈
쏉	쏉
쏊	쏊
쏋	쏋
쏌	쏌
쏍	쏍
쏎	쏎
쏏	쏏
쏐	쏐
쏑	쏑
쏒	쏒
쏓	쏓
쏔	쏔
쏕	쏕
쏖	쏖
쏗	쏗
쏘	쏘
쏙	쏙
쏚	쏚
쏛	쏛
쏜	쏜
쏝	쏝
쏞	쏞
쏟	쏟
쏠	쏠
쏡	쏡
쏢	쏢
쏣	쏣
쏤	쏤
쏥	쏥
쏦	쏦
쏧	쏧
쏨	쏨
쏩	쏩
쏪	쏪
쏫	쏫
쏬	쏬
쏭	쏭
쏮	쏮
쏯	쏯
쏰	쏰
쏱	쏱
쏲	쏲
쏳	쏳
쏴	쏴
쏵	쏵
쏶	쏶
쏷	쏷
쏸	쏸
쏹	쏹
쏺	쏺
쏻	쏻
쏼	쏼
쏽	쏽
쏾	쏾
쏿	쏿
쐀	쐀
쐁	쐁
쐂	쐂
쐃	쐃
쐄	쐄
쐅	쐅
쐆	쐆
쐇	쐇
쐈	쐈
쐉	쐉
쐊	쐊
쐋	쐋
쐌	쐌
쐍	쐍
쐎	쐎
쐏	쐏
쐐	쐐
쐑	쐑
쐒	쐒
쐓	쐓
쐔	쐔
쐕	쐕
쐖	쐖
쐗	쐗
쐘	쐘
쐙	쐙
쐚	쐚
쐛	쐛
쐜	쐜
쐝	쐝
쐞	쐞
쐟	쐟
쐠	쐠
쐡	쐡
쐢	쐢
쐣	쐣
쐤	쐤
쐥	쐥
쐦	쐦
쐧	쐧
쐨	쐨
쐩	쐩
쐪	쐪
쐫	쐫
쐬	쐬
쐭	쐭
쐮	쐮
쐯	쐯
쐰	쐰
쐱	쐱
쐲	쐲
쐳	쐳
쐴	쐴
쐵	쐵
쐶	쐶
쐷	쐷
쐸	쐸
쐹	쐹
쐺	쐺
쐻	쐻
쐼	쐼
쐽	쐽
쐾	쐾
쐿	쐿
쑀	쑀
쑁	쑁
쑂	쑂
쑃	쑃
쑄	쑄
쑅	쑅
쑆	쑆
쑇	쑇
쑈	쑈
쑉	쑉
쑊	쑊
쑋	쑋
쑌	쑌
쑍	쑍
쑎	쑎
쑏	쑏
쑐	쑐
쑑	쑑
쑒	쑒
쑓	쑓
쑔	쑔
쑕	쑕
쑖	쑖
쑗	쑗
쑘	쑘
쑙	쑙
쑚	쑚
쑛	쑛
쑜	쑜
쑝	쑝
쑞	쑞
쑟	쑟
쑠	쑠
쑡	쑡
쑢	쑢
쑣	쑣
쑤	쑤
쑥	쑥
쑦	쑦
쑧	쑧
쑨	쑨
쑩	쑩
쑪	쑪
쑫	쑫
쑬	쑬
쑭	쑭
쑮	쑮
쑯	쑯
쑰	쑰
쑱	쑱
쑲	쑲
쑳	쑳
쑴	쑴
쑵	쑵
쑶	쑶
쑷	쑷
쑸	쑸
쑹	쑹
쑺	쑺
쑻	쑻
쑼	쑼
쑽	쑽
쑾	쑾
쑿	쑿
쒀	쒀
쒁	쒁
쒂	쒂
쒃	쒃
쒄	쒄
쒅	쒅
쒆	쒆
쒇	쒇
쒈	쒈
쒉	쒉
쒊	쒊
쒋	쒋
쒌	쒌
쒍	쒍
쒎	쒎
쒏	쒏
쒐	쒐
쒑	쒑
쒒	쒒
쒓	쒓
쒔	쒔
쒕	쒕
쒖	쒖
쒗	쒗
쒘	쒘
쒙	쒙
쒚	쒚
쒛	쒛
쒜	쒜
쒝	쒝
쒞	쒞
쒟	쒟
쒠	쒠
쒡	쒡
쒢	쒢
쒣	쒣
쒤	쒤
쒥	쒥
쒦	쒦
쒧	쒧
쒨	쒨
쒩	쒩
쒪	쒪
쒫	쒫
쒬	쒬
쒭	쒭
쒮	쒮
쒯	쒯
쒰	쒰
쒱	쒱
쒲	쒲
쒳	쒳
쒴	쒴
쒵	쒵
쒶	쒶
쒷	쒷
쒸	쒸
쒹	쒹
쒺	쒺
쒻	쒻
쒼	쒼
쒽	쒽
쒾	쒾
쒿	쒿
쓀	쓀
쓁	쓁
쓂	쓂
쓃	쓃
쓄	쓄
쓅	쓅
쓆	쓆
쓇	쓇
쓈	쓈
쓉	쓉
쓊	쓊
쓋	쓋
쓌	쓌
쓍	쓍
쓎	쓎
쓏	쓏
쓐	쓐
쓑	쓑
쓒	쓒
쓓	쓓
쓔	쓔
쓕	쓕
쓖	쓖
쓗	쓗
쓘	쓘
쓙	쓙
쓚	쓚
쓛	쓛
쓜	쓜
쓝	쓝
쓞	쓞
쓟	쓟
쓠	쓠
쓡	쓡
쓢	쓢
쓣	쓣
쓤	쓤
쓥	쓥
쓦	쓦
쓧	쓧
쓨	쓨
쓩	쓩
쓪	쓪
쓫	쓫
쓬	쓬
쓭	쓭
쓮	쓮
쓯	쓯
쓰	쓰
쓱	쓱
쓲	쓲
쓳	쓳
쓴	쓴
쓵	쓵
쓶	쓶
쓷	쓷
쓸	쓸
쓹	쓹
쓺	쓺
쓻	쓻
쓼	쓼
쓽	쓽
쓾	쓾
쓿	쓿
씀	씀
씁	씁
씂	씂
씃	씃
씄	씄
씅	씅
씆	씆
씇	씇
씈	씈
씉	씉
씊	씊
씋	씋
씌	씌
씍	씍
씎	씎
씏	씏
씐	씐
씑	씑
씒	씒
씓	씓
씔	씔
씕	씕
씖	씖
씗	씗
씘	씘
씙	씙
씚	씚
씛	씛
씜	씜
씝	씝
씞	씞
씟	씟
씠	씠
씡	씡
씢	씢
씣	씣
씤	씤
씥	씥
씦	씦
씧	씧
씨	씨
씩	씩
씪	씪
씫	씫
씬	씬
씭	씭
씮	씮
씯	씯
씰	씰
씱	씱
씲	씲
씳	씳
씴	씴
씵	씵
씶	씶
씷	씷
씸	씸
씹	씹
씺	씺
씻	씻
씼	씼
씽	씽
씾	씾
씿	씿
앀	앀
앁	앁
앂	앂
앃	앃
아	아
악	악
앆	앆
앇	앇
안	안
앉	앉
않	않
앋	앋
알	알
앍	앍
앎	앎
앏	앏
앐	앐
앑	앑
앒	앒
앓	앓
암	암
압	압
앖	앖
앗	앗
았	았
앙	앙
앚	앚
앛	앛
앜	앜
앝	앝
앞	앞
앟	앟
애	애
액	액
앢	앢
앣	앣
앤	앤
앥	앥
앦	앦
앧	앧
앨	앨
앩	앩
앪	앪
앫	앫
앬	앬
앭	앭
앮	앮
앯	앯
앰	앰
앱	앱
앲	앲
앳	앳
앴	앴
앵	앵
앶	앶
앷	앷
앸	앸
앹	앹
앺	앺
앻	앻
야	야
약	약
앾	앾
앿	앿
얀	얀
얁	얁
얂	얂
얃	얃
얄	얄
얅	얅
얆	얆
얇	얇
얈	얈
얉	얉
얊	얊
얋	얋
얌	얌
얍	얍
얎	얎
얏	얏
얐	얐
양	양
얒	얒
얓	얓
얔	얔
얕	얕
얖	얖
얗	얗
얘	얘
얙	얙
얚	얚
얛	얛
얜	얜
얝	얝
얞	얞
얟	얟
얠	얠
얡	얡
얢	얢
얣	얣
얤	얤
얥	얥
얦	얦
얧	얧
얨	얨
얩	얩
얪	얪
얫	얫
얬	얬
얭	얭
얮	얮
얯	얯
얰	얰
얱	얱
얲	얲
얳	얳
어	어
억	억
얶	얶
얷	얷
언	언
얹	얹
얺	얺
얻	얻
얼	얼
얽	얽
얾	얾
얿	얿
엀	엀
엁	엁
엂	엂
엃	엃
엄	엄
업	업
없	없
엇	엇
었	었
엉	엉
엊	엊
엋	엋
엌	엌
엍	엍
엎	엎
엏	엏
에	에
엑	엑
엒	엒
엓	엓
엔	엔
엕	엕
엖	엖
엗	엗
엘	엘
엙	엙
엚	엚
엛	엛
엜	엜
엝	엝
엞	엞
엟	엟
엠	엠
엡	엡
엢	엢
엣	엣
엤	엤
엥	엥
엦	엦
엧	엧
엨	엨
엩	엩
엪	엪
엫	엫
여	여
역	역
엮	엮
엯	엯
연	연
엱	엱
엲	엲
엳	엳
열	열
엵	엵
엶	엶
엷	엷
엸	엸
엹	엹
엺	엺
엻	엻
염	염
엽	엽
엾	엾
엿	엿
였	였
영	영
옂	옂
옃	옃
옄	옄
옅	옅
옆	옆
옇	옇
예	예
옉	옉
옊	옊
옋	옋
옌	옌
옍	옍
옎	옎
옏	옏
옐	옐
옑	옑
옒	옒
옓	옓
옔	옔
옕	옕
옖	옖
옗	옗
옘	옘
옙	옙
옚	옚
옛	옛
옜	옜
옝	옝
옞	옞
옟	옟
옠	옠
옡	옡
옢	옢
옣	옣
오	오
옥	옥
옦	옦
옧	옧
온	온
옩	옩
옪	옪
옫	옫
올	올
옭	옭
옮	옮
옯	옯
옰	옰
옱	옱
옲	옲
옳	옳
옴	옴
옵	옵
옶	옶
옷	옷
옸	옸
옹	옹
옺	옺
옻	옻
옼	옼
옽	옽
옾	옾
옿	옿
와	와
왁	왁
왂	왂
왃	왃
완	완
왅	왅
왆	왆
왇	왇
왈	왈
왉	왉
왊	왊
왋	왋
왌	왌
왍	왍
왎	왎
왏	왏
왐	왐
왑	왑
왒	왒
왓	왓
왔	왔
왕	왕
왖	왖
왗	왗
왘	왘
왙	왙
왚	왚
왛	왛
왜	왜
왝	왝
왞	왞
왟	왟
왠	왠
왡	왡
왢	왢
왣	왣
왤	왤
왥	왥
왦	왦
왧	왧
왨	왨
왩	왩
왪	왪
왫	왫
왬	왬
왭	왭
왮	왮
왯	왯
왰	왰
왱	왱
왲	왲
왳	왳
왴	왴
왵	왵
왶	왶
왷	왷
외	외
왹	왹
왺	왺
왻	왻
왼	왼
왽	왽
왾	왾
왿	왿
욀	욀
욁	욁
욂	욂
욃	욃
욄	욄
욅	욅
욆	욆
욇	욇
욈	욈
욉	욉
욊	욊
욋	욋
욌	욌
욍	욍
욎	욎
욏	욏
욐	욐
욑	욑
욒	욒
욓	욓
요	요
욕	욕
욖	욖
욗	욗
욘	욘
욙	욙
욚	욚
욛	욛
욜	욜
욝	욝
욞	욞
욟	욟
욠	욠
욡	욡
욢	욢
욣	욣
욤	욤
욥	욥
욦	욦
욧	욧
욨	욨
용	용
욪	욪
욫	욫
욬	욬
욭	욭
욮	욮
욯	욯
우	우
욱	욱
욲	욲
욳	욳
운	운
욵	욵
욶	욶
욷	욷
울	울
욹	욹
욺	욺
욻	욻
욼	욼
욽	욽
욾	욾
욿	욿
움	움
웁	웁
웂	웂
웃	웃
웄	웄
웅	웅
웆	웆
웇	웇
웈	웈
웉	웉
웊	웊
웋	웋
워	워
웍	웍
웎	웎
웏	웏
원	원
웑	웑
웒	웒
웓	웓
월	월
웕	웕
웖	웖
웗	웗
웘	웘
웙	웙
웚	웚
웛	웛
웜	웜
웝	웝
웞	웞
웟	웟
웠	웠
웡	웡
웢	웢
웣	웣
웤	웤
웥	웥
웦	웦
웧	웧
웨	웨
웩	웩
웪	웪
웫	웫
웬	웬
웭	웭
웮	웮
웯	웯
웰	웰
웱	웱
웲	웲
웳	웳
웴	웴
웵	웵
웶	웶
웷	웷
웸	웸
웹	웹
웺	웺
웻	웻
웼	웼
웽	웽
웾	웾
웿	웿
윀	윀
윁	윁
윂	윂
윃	윃
위	위
윅	윅
윆	윆
윇	윇
윈	윈
윉	윉
윊	윊
윋	윋
윌	윌
윍	윍
윎	윎
윏	윏
윐	윐
윑	윑
윒	윒
윓	윓
윔	윔
윕	윕
윖	윖
윗	윗
윘	윘
윙	윙
윚	윚
윛	윛
윜	윜
윝	윝
윞	윞
윟	윟
유	유
육	육
윢	윢
윣	윣
윤	윤
윥	윥
윦	윦
윧	윧
율	율
윩	윩
윪	윪
윫	윫
윬	윬
윭	윭
윮	윮
윯	윯
윰	윰
윱	윱
윲	윲
윳	윳
윴	윴
융	융
윶	윶
윷	윷
윸	윸
윹	윹
윺	윺
윻	윻
으	으
윽	윽
윾	윾
윿	윿
은	은
읁	읁
읂	읂
읃	읃
을	을
읅	읅
읆	읆
읇	읇
읈	읈
읉	읉
읊	읊
읋	읋
음	음
읍	읍
읎	읎
읏	읏
읐	읐
응	응
읒	읒
읓	읓
읔	읔
읕	읕
읖	읖
읗	읗
의	의
읙	읙
읚	읚
읛	읛
읜	읜
읝	읝
읞	읞
읟	읟
읠	읠
읡	읡
읢	읢
읣	읣
읤	읤
읥	읥
읦	읦
읧	읧
읨	읨
읩	읩
읪	읪
읫	읫
읬	읬
읭	읭
읮	읮
읯	읯
읰	읰
읱	읱
읲	읲
읳	읳
이	이
익	익
읶	읶
읷	읷
인	인
읹	읹
읺	읺
읻	읻
일	일
읽	읽
읾	읾
읿	읿
잀	잀
잁	잁
잂	잂
잃	잃
임	임
입	입
잆	잆
잇	잇
있	있
잉	잉
잊	잊
잋	잋
잌	잌
잍	잍
잎	잎
잏	잏
자	자
작	작
잒	잒
잓	잓
잔	잔
잕	잕
잖	잖
잗	잗
잘	잘
잙	잙
잚	잚
잛	잛
잜	잜
잝	잝
잞	잞
잟	잟
잠	잠
잡	잡
잢	잢
잣	잣
잤	잤
장	장
잦	잦
잧	잧
잨	잨
잩	잩
잪	잪
잫	잫
재	재
잭	잭
잮	잮
잯	잯
잰	잰
잱	잱
잲	잲
잳	잳
잴	잴
잵	잵
잶	잶
잷	잷
잸	잸
잹	잹
잺	잺
잻	잻
잼	잼
잽	잽
잾	잾
잿	잿
쟀	쟀
쟁	쟁
쟂	쟂
쟃	쟃
쟄	쟄
쟅	쟅
쟆	쟆
쟇	쟇
쟈	쟈
쟉	쟉
쟊	쟊
쟋	쟋
쟌	쟌
쟍	쟍
쟎	쟎
쟏	쟏
쟐	쟐
쟑	쟑
쟒	쟒
쟓	쟓
쟔	쟔
쟕	쟕
쟖	쟖
쟗	쟗
쟘	쟘
쟙	쟙
쟚	쟚
쟛	쟛
쟜	쟜
쟝	쟝
쟞	쟞
쟟	쟟
쟠	쟠
쟡	쟡
쟢	쟢
쟣	쟣
쟤	쟤
쟥	쟥
쟦	쟦
쟧	쟧
쟨	쟨
쟩	쟩
쟪	쟪
쟫	쟫
쟬	쟬
쟭	쟭
쟮	쟮
쟯	쟯
쟰	쟰
쟱	쟱
쟲	쟲
쟳	쟳
쟴	쟴
쟵	쟵
쟶	쟶
쟷	쟷
쟸	쟸
쟹	쟹
쟺	쟺
쟻	쟻
쟼	쟼
쟽	쟽
쟾	쟾
쟿	쟿
저	저
적	적
젂	젂
젃	젃
전	전
젅	젅
젆	젆
젇	젇
절	절
젉	젉
젊	젊
젋	젋
젌	젌
젍	젍
젎	젎
젏	젏
점	점
접	접
젒	젒
젓	젓
젔	젔
정	정
젖	젖
젗	젗
젘	젘
젙	젙
젚	젚
젛	젛
제	제
젝	젝
젞	젞
젟	젟
젠	젠
젡	젡
젢	젢
젣	젣
젤	젤
젥	젥
젦	젦
젧	젧
젨	젨
젩	젩
젪	젪
젫	젫
젬	젬
젭	젭
젮	젮
젯	젯
젰	젰
젱	젱
젲	젲
젳	젳
젴	젴
젵	젵
젶	젶
젷	젷
져	져
젹	젹
젺	젺
젻	젻
젼	젼
젽	젽
젾	젾
젿	젿
졀	졀
졁	졁
졂	졂
졃	졃
졄	졄
졅	졅
졆	졆
졇	졇
졈	졈
졉	졉
졊	졊
졋	졋
졌	졌
졍	졍
졎	졎
졏	졏
졐	졐
졑	졑
졒	졒
졓	졓
졔	졔
졕	졕
졖	졖
졗	졗
졘	졘
졙	졙
졚	졚
졛	졛
졜	졜
졝	졝
졞	졞
졟	졟
졠	졠
졡	졡
졢	졢
졣	졣
졤	졤
졥	졥
졦	졦
졧	졧
졨	졨
졩	졩
졪	졪
졫	졫
졬	졬
졭	졭
졮	졮
졯	졯
조	조
족	족
졲	졲
졳	졳
존	존
졵	졵
졶	졶
졷	졷
졸	졸
졹	졹
졺	졺
졻	졻
졼	졼
졽	졽
졾	졾
졿	졿
좀	좀
좁	좁
좂	좂
좃	좃
좄	좄
종	종
좆	좆
좇	좇
좈	좈
좉	좉
좊	좊
좋	좋
좌	좌
좍	좍
좎	좎
좏	좏
좐	좐
좑	좑
좒	좒
좓	좓
좔	좔
좕	좕
좖	좖
좗	좗
좘	좘
좙	좙
좚	좚
좛	좛
좜	좜
좝	좝
좞	좞
좟	좟
좠	좠
좡	좡
좢	좢
좣	좣
좤	좤
좥	좥
좦	좦
좧	좧
좨	좨
좩	좩
좪	좪
좫	좫
좬	좬
좭	좭
좮	좮
좯	좯
좰	좰
좱	좱
좲	좲
좳	좳
좴	좴
좵	좵
좶	좶
좷	좷
좸	좸
좹	좹
좺	좺
좻	좻
좼	좼
좽	좽
좾	좾
좿	좿
죀	죀
죁	죁
죂	죂
죃	죃
죄	죄
죅	죅
죆	죆
죇	죇
죈	죈
죉	죉
죊	죊
죋	죋
죌	죌
죍	죍
죎	죎
죏	죏
죐	죐
죑	죑
죒	죒
죓	죓
죔	죔
죕	죕
죖	죖
죗	죗
죘	죘
죙	죙
죚	죚
죛	죛
죜	죜
죝	죝
죞	죞
죟	죟
죠	죠
죡	죡
죢	죢
죣	죣
죤	죤
죥	죥
죦	죦
죧	죧
죨	죨
죩	죩
죪	죪
죫	죫
죬	죬
죭	죭
죮	죮
죯	죯
죰	죰
죱	죱
죲	죲
죳	죳
죴	죴
죵	죵
죶	죶
죷	죷
죸	죸
죹	죹
죺	죺
죻	죻
주	주
죽	죽
죾	죾
죿	죿
준	준
줁	줁
줂	줂
줃	줃
줄	줄
줅	줅
줆	줆
줇	줇
줈	줈
줉	줉
줊	줊
줋	줋
줌	줌
줍	줍
줎	줎
줏	줏
줐	줐
중	중
줒	줒
줓	줓
줔	줔
줕	줕
줖	줖
줗	줗
줘	줘
줙	줙
줚	줚
줛	줛
줜	줜
줝	줝
줞	줞
줟	줟
줠	줠
줡	줡
줢	줢
줣	줣
줤	줤
줥	줥
줦	줦
줧	줧
줨	줨
줩	줩
줪	줪
줫	줫
줬	줬
줭	줭
줮	줮
줯	줯
줰	줰
줱	줱
줲	줲
줳	줳
줴	줴
줵	줵
줶	줶
줷	줷
줸	줸
줹	줹
줺	줺
줻	줻
줼	줼
줽	줽
줾	줾
줿	줿
쥀	쥀
쥁	쥁
쥂	쥂
쥃	쥃
쥄	쥄
쥅	쥅
쥆	쥆
쥇	쥇
쥈	쥈
쥉	쥉
쥊	쥊
쥋	쥋
쥌	쥌
쥍	쥍
쥎	쥎
쥏	쥏
쥐	쥐
쥑	쥑
쥒	쥒
쥓	쥓
쥔	쥔
쥕	쥕
쥖	쥖
쥗	쥗
쥘	쥘
쥙	쥙
쥚	쥚
쥛	쥛
쥜	쥜
쥝	쥝
쥞	쥞
쥟	쥟
쥠	쥠
쥡	쥡
쥢	쥢
쥣	쥣
쥤	쥤
쥥	쥥
쥦	쥦
쥧	쥧
쥨	쥨
쥩	쥩
쥪	쥪
쥫	쥫
쥬	쥬
쥭	쥭
쥮	쥮
쥯	쥯
쥰	쥰
쥱	쥱
쥲	쥲
쥳	쥳
쥴	쥴
쥵	쥵
쥶	쥶
쥷	쥷
쥸	쥸
쥹	쥹
쥺	쥺
쥻	쥻
쥼	쥼
쥽	쥽
쥾	쥾
쥿	쥿
즀	즀
즁	즁
즂	즂
즃	즃
즄	즄
즅	즅
즆	즆
즇	즇
즈	즈
즉	즉
즊	즊
즋	즋
즌	즌
즍	즍
즎	즎
즏	즏
즐	즐
즑	즑
즒	즒
즓	즓
즔	즔
즕	즕
즖	즖
즗	즗
즘	즘
즙	즙
즚	즚
즛	즛
즜	즜
증	증
즞	즞
즟	즟
즠	즠
즡	즡
즢	즢
즣	즣
즤	즤
즥	즥
즦	즦
즧	즧
즨	즨
즩	즩
즪	즪
즫	즫
즬	즬
즭	즭
즮	즮
즯	즯
즰	즰
즱	즱
즲	즲
즳	즳
즴	즴
즵	즵
즶	즶
즷	즷
즸	즸
즹	즹
즺	즺
즻	즻
즼	즼
즽	즽
즾	즾
즿	즿
지	지
직	직
짂	짂
짃	짃
진	진
짅	짅
짆	짆
짇	짇
질	질
짉	짉
짊	짊
짋	짋
짌	짌
짍	짍
짎	짎
짏	짏
짐	짐
집	집
짒	짒
짓	짓
짔	짔
징	징
짖	짖
짗	짗
짘	짘
짙	짙
짚	짚
짛	짛
짜	짜
짝	짝
짞	짞
짟	짟
짠	짠
짡	짡
짢	짢
짣	짣
짤	짤
짥	짥
짦	짦
짧	짧
짨	짨
짩	짩
짪	짪
짫	짫
짬	짬
짭	짭
짮	짮
짯	짯
짰	짰
짱	짱
짲	짲
짳	짳
짴	짴
짵	짵
짶	짶
짷	짷
째	째
짹	짹
짺	짺
짻	짻
짼	짼
짽	짽
짾	짾
짿	짿
쨀	쨀
쨁	쨁
쨂	쨂
쨃	쨃
쨄	쨄
쨅	쨅
쨆	쨆
쨇	쨇
쨈	쨈
쨉	쨉
쨊	쨊
쨋	쨋
쨌	쨌
쨍	쨍
쨎	쨎
쨏	쨏
쨐	쨐
쨑	쨑
쨒	쨒
쨓	쨓
쨔	쨔
쨕	쨕
쨖	쨖
쨗	쨗
쨘	쨘
쨙	쨙
쨚	쨚
쨛	쨛
쨜	쨜
쨝	쨝
쨞	쨞
쨟	쨟
쨠	쨠
쨡	쨡
쨢	쨢
쨣	쨣
쨤	쨤
쨥	쨥
쨦	쨦
쨧	쨧
쨨	쨨
쨩	쨩
쨪	쨪
쨫	쨫
쨬	쨬
쨭	쨭
쨮	쨮
쨯	쨯
쨰	쨰
쨱	쨱
쨲	쨲
쨳	쨳
쨴	쨴
쨵	쨵
쨶	쨶
쨷	쨷
쨸	쨸
쨹	쨹
쨺	쨺
쨻	쨻
쨼	쨼
쨽	쨽
쨾	쨾
쨿	쨿
쩀	쩀
쩁	쩁
쩂	쩂
쩃	쩃
쩄	쩄
쩅	쩅
쩆	쩆
쩇	쩇
쩈	쩈
쩉	쩉
쩊	쩊
쩋	쩋
쩌	쩌
쩍	쩍
쩎	쩎
쩏	쩏
쩐	쩐
쩑	쩑
쩒	쩒
쩓	쩓
쩔	쩔
쩕	쩕
쩖	쩖
쩗	쩗
쩘	쩘
쩙	쩙
쩚	쩚
쩛	쩛
쩜	쩜
쩝	쩝
쩞	쩞
쩟	쩟
쩠	쩠
쩡	쩡
쩢	쩢
쩣	쩣
쩤	쩤
쩥	쩥
쩦	쩦
쩧	쩧
쩨	쩨
쩩	쩩
쩪	쩪
쩫	쩫
쩬	쩬
쩭	쩭
쩮	쩮
쩯	쩯
쩰	쩰
쩱	쩱
쩲	쩲
쩳	쩳
쩴	쩴
쩵	쩵
쩶	쩶
쩷	쩷
쩸	쩸
쩹	쩹
쩺	쩺
쩻	쩻
쩼	쩼
쩽	쩽
쩾	쩾
쩿	쩿
쪀	쪀
쪁	쪁
쪂	쪂
쪃	쪃
쪄	쪄
쪅	쪅
쪆	쪆
쪇	쪇
쪈	쪈
쪉	쪉
쪊	쪊
쪋	쪋
쪌	쪌
쪍	쪍
쪎	쪎
쪏	쪏
쪐	쪐
쪑	쪑
쪒	쪒
쪓	쪓
쪔	쪔
쪕	쪕
쪖	쪖
쪗	쪗
쪘	쪘
쪙	쪙
쪚	쪚
쪛	쪛
쪜	쪜
쪝	쪝
쪞	쪞
쪟	쪟
쪠	쪠
쪡	쪡
쪢	쪢
쪣	쪣
쪤	쪤
쪥	쪥
쪦	쪦
쪧	쪧
쪨	쪨
쪩	쪩
쪪	쪪
쪫	쪫
쪬	쪬
쪭	쪭
쪮	쪮
쪯	쪯
쪰	쪰
쪱	쪱
쪲	쪲
쪳	쪳
쪴	쪴
쪵	쪵
쪶	쪶
쪷	쪷
쪸	쪸
쪹	쪹
쪺	쪺
쪻	쪻
쪼	쪼
쪽	쪽
쪾	쪾
쪿	쪿
쫀	쫀
쫁	쫁
쫂	쫂
쫃	쫃
쫄	쫄
쫅	쫅
쫆	쫆
쫇	쫇
쫈	쫈
쫉	쫉
쫊	쫊
쫋	쫋
쫌	쫌
쫍	쫍
쫎	쫎
쫏	쫏
쫐	쫐
쫑	쫑
쫒	쫒
쫓	쫓
쫔	쫔
쫕	쫕
쫖	쫖
쫗	쫗
쫘	쫘
쫙	쫙
쫚	쫚
쫛	쫛
쫜	쫜
쫝	쫝
쫞	쫞
쫟	쫟
쫠	쫠
쫡	쫡
쫢	쫢
쫣	쫣
쫤	쫤
쫥	쫥
쫦	쫦
쫧	쫧
쫨	쫨
쫩	쫩
쫪	쫪
쫫	쫫
쫬	쫬
쫭	쫭
쫮	쫮
쫯	쫯
쫰	쫰
쫱	쫱
쫲	쫲
쫳	쫳
쫴	쫴
쫵	쫵
쫶	쫶
쫷	쫷
쫸	쫸
쫹	쫹
쫺	쫺
쫻	쫻
쫼	쫼
쫽	쫽
쫾	쫾
쫿	쫿
쬀	쬀
쬁	쬁
쬂	쬂
쬃	쬃
쬄	쬄
쬅	쬅
쬆	쬆
쬇	쬇
쬈	쬈
쬉	쬉
쬊	쬊
쬋	쬋
쬌	쬌
쬍	쬍
쬎	쬎
쬏	쬏
쬐	쬐
쬑	쬑
쬒	쬒
쬓	쬓
쬔	쬔
쬕	쬕
쬖	쬖
쬗	쬗
쬘	쬘
쬙	쬙
쬚	쬚
쬛	쬛
쬜	쬜
쬝	쬝
쬞	쬞
쬟	쬟
쬠	쬠
쬡	쬡
쬢	쬢
쬣	쬣
쬤	쬤
쬥	쬥
쬦	쬦
쬧	쬧
쬨	쬨
쬩	쬩
쬪	쬪
쬫	쬫
쬬	쬬
쬭	쬭
쬮	쬮
쬯	쬯
쬰	쬰
쬱	쬱
쬲	쬲
쬳	쬳
쬴	쬴
쬵	쬵
쬶	쬶
쬷	쬷
쬸	쬸
쬹	쬹
쬺	쬺
쬻	쬻
쬼	쬼
쬽	쬽
쬾	쬾
쬿	쬿
쭀	쭀
쭁	쭁
쭂	쭂
쭃	쭃
쭄	쭄
쭅	쭅
쭆	쭆
쭇	쭇
쭈	쭈
쭉	쭉
쭊	쭊
쭋	쭋
쭌	쭌
쭍	쭍
쭎	쭎
쭏	쭏
쭐	쭐
쭑	쭑
쭒	쭒
쭓	쭓
쭔	쭔
쭕	쭕
쭖	쭖
쭗	쭗
쭘	쭘
쭙	쭙
쭚	쭚
쭛	쭛
쭜	쭜
쭝	쭝
쭞	쭞
쭟	쭟
쭠	쭠
쭡	쭡
쭢	쭢
쭣	쭣
쭤	쭤
쭥	쭥
쭦	쭦
쭧	쭧
쭨	쭨
쭩	쭩
쭪	쭪
쭫	쭫
쭬	쭬
쭭	쭭
쭮	쭮
쭯	쭯
쭰	쭰
쭱	쭱
쭲	쭲
쭳	쭳
쭴	쭴
쭵	쭵
쭶	쭶
쭷	쭷
쭸	쭸
쭹	쭹
쭺	쭺
쭻	쭻
쭼	쭼
쭽	쭽
쭾	쭾
쭿	쭿
쮀	쮀
쮁	쮁
쮂	쮂
쮃	쮃
쮄	쮄
쮅	쮅
쮆	쮆
쮇	쮇
쮈	쮈
쮉	쮉
쮊	쮊
쮋	쮋
쮌	쮌
쮍	쮍
쮎	쮎
쮏	쮏
쮐	쮐
쮑	쮑
쮒	쮒
쮓	쮓
쮔	쮔
쮕	쮕
쮖	쮖
쮗	쮗
쮘	쮘
쮙	쮙
쮚	쮚
쮛	쮛
쮜	쮜
쮝	쮝
쮞	쮞
쮟	쮟
쮠	쮠
쮡	쮡
쮢	쮢
쮣	쮣
쮤	쮤
쮥	쮥
쮦	쮦
쮧	쮧
쮨	쮨
쮩	쮩
쮪	쮪
쮫	쮫
쮬	쮬
쮭	쮭
쮮	쮮
쮯	쮯
쮰	쮰
쮱	쮱
쮲	쮲
쮳	쮳
쮴	쮴
쮵	쮵
쮶	쮶
쮷	쮷
쮸	쮸
쮹	쮹
쮺	쮺
쮻	쮻
쮼	쮼
쮽	쮽
쮾	쮾
쮿	쮿
쯀	쯀
쯁	쯁
쯂	쯂
쯃	쯃
쯄	쯄
쯅	쯅
쯆	쯆
쯇	쯇
쯈	쯈
쯉	쯉
쯊	쯊
쯋	쯋
쯌	쯌
쯍	쯍
쯎	쯎
쯏	쯏
쯐	쯐
쯑	쯑
쯒	쯒
쯓	쯓
쯔	쯔
쯕	쯕
쯖	쯖
쯗	쯗
쯘	쯘
쯙	쯙
쯚	쯚
쯛	쯛
쯜	쯜
쯝	쯝
쯞	쯞
쯟	쯟
쯠	쯠
쯡	쯡
쯢	쯢
쯣	쯣
쯤	쯤
쯥	쯥
쯦	쯦
쯧	쯧
쯨	쯨
쯩	쯩
쯪	쯪
쯫	쯫
쯬	쯬
쯭	쯭
쯮	쯮
쯯	쯯
쯰	쯰
쯱	쯱
쯲	쯲
쯳	쯳
쯴	쯴
쯵	쯵
쯶	쯶
쯷	쯷
쯸	쯸
쯹	쯹
쯺	쯺
쯻	쯻
쯼	쯼
쯽	쯽
쯾	쯾
쯿	쯿
찀	찀
찁	찁
찂	찂
찃	찃
찄	찄
찅	찅
찆	찆
찇	찇
찈	찈
찉	찉
찊	찊
찋	찋
찌	찌
찍	찍
찎	찎
찏	찏
찐	찐
찑	찑
찒	찒
찓	찓
찔	찔
찕	찕
찖	찖
찗	찗
찘	찘
찙	찙
찚	찚
찛	찛
찜	찜
찝	찝
찞	찞
찟	찟
찠	찠
찡	찡
찢	찢
찣	찣
찤	찤
찥	찥
찦	찦
찧	찧
차	차
착	착
찪	찪
찫	찫
찬	찬
찭	찭
찮	찮
찯	찯
찰	찰
찱	찱
찲	찲
찳	찳
찴	찴
찵	찵
찶	찶
찷	찷
참	참
찹	찹
찺	찺
찻	찻
찼	찼
창	창
찾	찾
찿	찿
챀	챀
챁	챁
챂	챂
챃	챃
채	채
책	책
챆	챆
챇	챇
챈	챈
챉	챉
챊	챊
챋	챋
챌	챌
챍	챍
챎	챎
챏	챏
챐	챐
챑	챑
챒	챒
챓	챓
챔	챔
챕	챕
챖	챖
챗	챗
챘	챘
챙	챙
챚	챚
챛	챛
챜	챜
챝	챝
챞	챞
챟	챟
챠	챠
챡	챡
챢	챢
챣	챣
챤	챤
챥	챥
챦	챦
챧	챧
챨	챨
챩	챩
챪	챪
챫	챫
챬	챬
챭	챭
챮	챮
챯	챯
챰	챰
챱	챱
챲	챲
챳	챳
챴	챴
챵	챵
챶	챶
챷	챷
챸	챸
챹	챹
챺	챺
챻	챻
챼	챼
챽	챽
챾	챾
챿	챿
첀	첀
첁	첁
첂	첂
첃	첃
첄	첄
첅	첅
첆	첆
첇	첇
첈	첈
첉	첉
첊	첊
첋	첋
첌	첌
첍	첍
첎	첎
첏	첏
첐	첐
첑	첑
첒	첒
첓	첓
첔	첔
첕	첕
첖	첖
첗	첗
처	처
척	척
첚	첚
첛	첛
천	천
첝	첝
첞	첞
첟	첟
철	철
첡	첡
첢	첢
첣	첣
첤	첤
첥	첥
첦	첦
첧	첧
첨	첨
첩	첩
첪	첪
첫	첫
첬	첬
청	청
첮	첮
첯	첯
첰	첰
첱	첱
첲	첲
첳	첳
체	체
첵	첵
첶	첶
첷	첷
첸	첸
첹	첹
첺	첺
첻	첻
첼	첼
첽	첽
첾	첾
첿	첿
쳀	쳀
쳁	쳁
쳂	쳂
쳃	쳃
쳄	쳄
쳅	쳅
쳆	쳆
쳇	쳇
쳈	쳈
쳉	쳉
쳊	쳊
쳋	쳋
쳌	쳌
쳍	쳍
쳎	쳎
쳏	쳏
쳐	쳐
쳑	쳑
쳒	쳒
쳓	쳓
쳔	쳔
쳕	쳕
쳖	쳖
쳗	쳗
쳘	쳘
쳙	쳙
쳚	쳚
쳛	쳛
쳜	쳜
쳝	쳝
쳞	쳞
쳟	쳟
쳠	쳠
쳡	쳡
쳢	쳢
쳣	쳣
쳤	쳤
쳥	쳥
쳦	쳦
쳧	쳧
쳨	쳨
쳩	쳩
쳪	쳪
쳫	쳫
쳬	쳬
쳭	쳭
쳮	쳮
쳯	쳯
쳰	쳰
쳱	쳱
쳲	쳲
쳳	쳳
쳴	쳴
쳵	쳵
쳶	쳶
쳷	쳷
쳸	쳸
쳹	쳹
쳺	쳺
쳻	쳻
쳼	쳼
쳽	쳽
쳾	쳾
쳿	쳿
촀	촀
촁	촁
촂	촂
촃	촃
촄	촄
촅	촅
촆	촆
촇	촇
초	초
촉	촉
촊	촊
촋	촋
촌	촌
촍	촍
촎	촎
촏	촏
촐	촐
촑	촑
촒	촒
촓	촓
촔	촔
촕	촕
촖	촖
촗	촗
촘	촘
촙	촙
촚	촚
촛	촛
촜	촜
총	총
촞	촞
촟	촟
촠	촠
촡	촡
촢	촢
촣	촣
촤	촤
촥	촥
촦	촦
촧	촧
촨	촨
촩	촩
촪	촪
촫	촫
촬	촬
촭	촭
촮	촮
촯	촯
촰	촰
촱	촱
촲	촲
촳	촳
촴	촴
촵	촵
촶	촶
촷	촷
촸	촸
촹	촹
촺	촺
촻	촻
촼	촼
촽	촽
촾	촾
촿	촿
쵀	쵀
쵁	쵁
쵂	쵂
쵃	쵃
쵄	쵄
쵅	쵅
쵆	쵆
쵇	쵇
쵈	쵈
쵉	쵉
쵊	쵊
쵋	쵋
쵌	쵌
쵍	쵍
쵎	쵎
쵏	쵏
쵐	쵐
쵑	쵑
쵒	쵒
쵓	쵓
쵔	쵔
쵕	쵕
쵖	쵖
쵗	쵗
쵘	쵘
쵙	쵙
쵚	쵚
쵛	쵛
최	최
쵝	쵝
쵞	쵞
쵟	쵟
쵠	쵠
쵡	쵡
쵢	쵢
쵣	쵣
쵤	쵤
쵥	쵥
쵦	쵦
쵧	쵧
쵨	쵨
쵩	쵩
쵪	쵪
쵫	쵫
쵬	쵬
쵭	쵭
쵮	쵮
쵯	쵯
쵰	쵰
쵱	쵱
쵲	쵲
쵳	쵳
쵴	쵴
쵵	쵵
쵶	쵶
쵷	쵷
쵸	쵸
쵹	쵹
쵺	쵺
쵻	쵻
쵼	쵼
쵽	쵽
쵾	쵾
쵿	쵿
춀	춀
춁	춁
춂	춂
춃	춃
춄	춄
춅	춅
춆	춆
춇	춇
춈	춈
춉	춉
춊	춊
춋	춋
춌	춌
춍	춍
춎	춎
춏	춏
춐	춐
춑	춑
춒	춒
춓	춓
추	추
축	축
춖	춖
춗	춗
춘	춘
춙	춙
춚	춚
춛	춛
출	출
춝	춝
춞	춞
춟	춟
춠	춠
춡	춡
춢	춢
춣	춣
춤	춤
춥	춥
춦	춦
춧	춧
춨	춨
충	충
춪	춪
춫	춫
춬	춬
춭	춭
춮	춮
춯	춯
춰	춰
춱	춱
춲	춲
춳	춳
춴	춴
춵	춵
춶	춶
춷	춷
춸	춸
춹	춹
춺	춺
춻	춻
춼	춼
춽	춽
춾	춾
춿	춿
췀	췀
췁	췁
췂	췂
췃	췃
췄	췄
췅	췅
췆	췆
췇	췇
췈	췈
췉	췉
췊	췊
췋	췋
췌	췌
췍	췍
췎	췎
췏	췏
췐	췐
췑	췑
췒	췒
췓	췓
췔	췔
췕	췕
췖	췖
췗	췗
췘	췘
췙	췙
췚	췚
췛	췛
췜	췜
췝	췝
췞	췞
췟	췟
췠	췠
췡	췡
췢	췢
췣	췣
췤	췤
췥	췥
췦	췦
췧	췧
취	취
췩	췩
췪	췪
췫	췫
췬	췬
췭	췭
췮	췮
췯	췯
췰	췰
췱	췱
췲	췲
췳	췳
췴	췴
췵	췵
췶	췶
췷	췷
췸	췸
췹	췹
췺	췺
췻	췻
췼	췼
췽	췽
췾	췾
췿	췿
츀	츀
츁	츁
츂	츂
츃	츃
츄	츄
츅	츅
츆	츆
츇	츇
츈	츈
츉	츉
츊	츊
츋	츋
츌	츌
츍	츍
츎	츎
츏	츏
츐	츐
츑	츑
츒	츒
츓	츓
츔	츔
츕	츕
츖	츖
츗	츗
츘	츘
츙	츙
츚	츚
츛	츛
츜	츜
츝	츝
츞	츞
츟	츟
츠	츠
측	측
츢	츢
츣	츣
츤	츤
츥	츥
츦	츦
츧	츧
츨	츨
츩	츩
츪	츪
츫	츫
츬	츬
츭	츭
츮	츮
츯	츯
츰	츰
츱	츱
츲	츲
츳	츳
츴	츴
층	층
츶	츶
츷	츷
츸	츸
츹	츹
츺	츺
츻	츻
츼	츼
츽	츽
츾	츾
츿	츿
칀	칀
칁	칁
칂	칂
칃	칃
칄	칄
칅	칅
칆	칆
칇	칇
칈	칈
칉	칉
칊	칊
칋	칋
칌	칌
칍	칍
칎	칎
칏	칏
칐	칐
칑	칑
칒	칒
칓	칓
칔	칔
칕	칕
칖	칖
칗	칗
치	치
칙	칙
칚	칚
칛	칛
친	친
칝	칝
칞	칞
칟	칟
칠	칠
칡	칡
칢	칢
칣	칣
칤	칤
칥	칥
칦	칦
칧	칧
침	침
칩	칩
칪	칪
칫	칫
칬	칬
칭	칭
칮	칮
칯	칯
칰	칰
칱	칱
칲	칲
칳	칳
카	카
칵	칵
칶	칶
칷	칷
칸	칸
칹	칹
칺	칺
칻	칻
칼	칼
칽	칽
칾	칾
칿	칿
캀	캀
캁	캁
캂	캂
캃	캃
캄	캄
캅	캅
캆	캆
캇	캇
캈	캈
캉	캉
캊	캊
캋	캋
캌	캌
캍	캍
캎	캎
캏	캏
캐	캐
캑	캑
캒	캒
캓	캓
캔	캔
캕	캕
캖	캖
캗	캗
캘	캘
캙	캙
캚	캚
캛	캛
캜	캜
캝	캝
캞	캞
캟	캟
캠	캠
캡	캡
캢	캢
캣	캣
캤	캤
캥	캥
캦	캦
캧	캧
캨	캨
캩	캩
캪	캪
캫	캫
캬	캬
캭	캭
캮	캮
캯	캯
캰	캰
캱	캱
캲	캲
캳	캳
캴	캴
캵	캵
캶	캶
캷	캷
캸	캸
캹	캹
캺	캺
캻	캻
캼	캼
캽	캽
캾	캾
캿	캿
컀	컀
컁	컁
컂	컂
컃	컃
컄	컄
컅	컅
컆	컆
컇	컇
컈	컈
컉	컉
컊	컊
컋	컋
컌	컌
컍	컍
컎	컎
컏	컏
컐	컐
컑	컑
컒	컒
컓	컓
컔	컔
컕	컕
컖	컖
컗	컗
컘	컘
컙	컙
컚	컚
컛	컛
컜	컜
컝	컝
컞	컞
컟	컟
컠	컠
컡	컡
컢	컢
컣	컣
커	커
컥	컥
컦	컦
컧	컧
컨	컨
컩	컩
컪	컪
컫	컫
컬	컬
컭	컭
컮	컮
컯	컯
컰	컰
컱	컱
컲	컲
컳	컳
컴	컴
컵	컵
컶	컶
컷	컷
컸	컸
컹	컹
컺	컺
컻	컻
컼	컼
컽	컽
컾	컾
컿	컿
케	케
켁	켁
켂	켂
켃	켃
켄	켄
켅	켅
켆	켆
켇	켇
켈	켈
켉	켉
켊	켊
켋	켋
켌	켌
켍	켍
켎	켎
켏	켏
켐	켐
켑	켑
켒	켒
켓	켓
켔	켔
켕	켕
켖	켖
켗	켗
켘	켘
켙	켙
켚	켚
켛	켛
켜	켜
켝	켝
켞	켞
켟	켟
켠	켠
켡	켡
켢	켢
켣	켣
켤	켤
켥	켥
켦	켦
켧	켧
켨	켨
켩	켩
켪	켪
켫	켫
켬	켬
켭	켭
켮	켮
켯	켯
켰	켰
켱	켱
켲	켲
켳	켳
켴	켴
켵	켵
켶	켶
켷	켷
켸	켸
켹	켹
켺	켺
켻	켻
켼	켼
켽	켽
켾	켾
켿	켿
콀	콀
콁	콁
콂	콂
콃	콃
콄	콄
콅	콅
콆	콆
콇	콇
콈	콈
콉	콉
콊	콊
콋	콋
콌	콌
콍	콍
콎	콎
콏	콏
콐	콐
콑	콑
콒	콒
콓	콓
코	코
콕	콕
콖	콖
콗	콗
콘	콘
콙	콙
콚	콚
콛	콛
콜	콜
콝	콝
콞	콞
콟	콟
콠	콠
콡	콡
콢	콢
콣	콣
콤	콤
콥	콥
콦	콦
콧	콧
콨	콨
콩	콩
콪	콪
콫	콫
콬	콬
콭	콭
콮	콮
콯	콯
콰	콰
콱	콱
콲	콲
콳	콳
콴	콴
콵	콵
콶	콶
콷	콷
콸	콸
콹	콹
콺	콺
콻	콻
콼	콼
콽	콽
콾	콾
콿	콿
쾀	쾀
쾁	쾁
쾂	쾂
쾃	쾃
쾄	쾄
쾅	쾅
쾆	쾆
쾇	쾇
쾈	쾈
쾉	쾉
쾊	쾊
쾋	쾋
쾌	쾌
쾍	쾍
쾎	쾎
쾏	쾏
쾐	쾐
쾑	쾑
쾒	쾒
쾓	쾓
쾔	쾔
쾕	쾕
쾖	쾖
쾗	쾗
쾘	쾘
쾙	쾙
쾚	쾚
쾛	쾛
쾜	쾜
쾝	쾝
쾞	쾞
쾟	쾟
쾠	쾠
쾡	쾡
쾢	쾢
쾣	쾣
쾤	쾤
쾥	쾥
쾦	쾦
쾧	쾧
쾨	쾨
쾩	쾩
쾪	쾪
쾫	쾫
쾬	쾬
쾭	쾭
쾮	쾮
쾯	쾯
쾰	쾰
쾱	쾱
쾲	쾲
쾳	쾳
쾴	쾴
쾵	쾵
쾶	쾶
쾷	쾷
쾸	쾸
쾹	쾹
쾺	쾺
쾻	쾻
쾼	쾼
쾽	쾽
쾾	쾾
쾿	쾿
쿀	쿀
쿁	쿁
쿂	쿂
쿃	쿃
쿄	쿄
쿅	쿅
쿆	쿆
쿇	쿇
쿈	쿈
쿉	쿉
쿊	쿊
쿋	쿋
쿌	쿌
쿍	쿍
쿎	쿎
쿏	쿏
쿐	쿐
쿑	쿑
쿒	쿒
쿓	쿓
쿔	쿔
쿕	쿕
쿖	쿖
쿗	쿗
쿘	쿘
쿙	쿙
쿚	쿚
쿛	쿛
쿜	쿜
쿝	쿝
쿞	쿞
쿟	쿟
쿠	쿠
쿡	쿡
쿢	쿢
쿣	쿣
쿤	쿤
쿥	쿥
쿦	쿦
쿧	쿧
쿨	쿨
쿩	쿩
쿪	쿪
쿫	쿫
쿬	쿬
쿭	쿭
쿮	쿮
쿯	쿯
쿰	쿰
쿱	쿱
쿲	쿲
쿳	쿳
쿴	쿴
쿵	쿵
쿶	쿶
쿷	쿷
쿸	쿸
쿹	쿹
쿺	쿺
쿻	쿻
쿼	쿼
쿽	쿽
쿾	쿾
쿿	쿿
퀀	퀀
퀁	퀁
퀂	퀂
퀃	퀃
퀄	퀄
퀅	퀅
퀆	퀆
퀇	퀇
퀈	퀈
퀉	퀉
퀊	퀊
퀋	퀋
퀌	퀌
퀍	퀍
퀎	퀎
퀏	퀏
퀐	퀐
퀑	퀑
퀒	퀒
퀓	퀓
퀔	퀔
퀕	퀕
퀖	퀖
퀗	퀗
퀘	퀘
퀙	퀙
퀚	퀚
퀛	퀛
퀜	퀜
퀝	퀝
퀞	퀞
퀟	퀟
퀠	퀠
퀡	퀡
퀢	퀢
퀣	퀣
퀤	퀤
퀥	퀥
퀦	퀦
퀧	퀧
퀨	퀨
퀩	퀩
퀪	퀪
퀫	퀫
퀬	퀬
퀭	퀭
퀮	퀮
퀯	퀯
퀰	퀰
퀱	퀱
퀲	퀲
퀳	퀳
퀴	퀴
퀵	퀵
퀶	퀶
퀷	퀷
퀸	퀸
퀹	퀹
퀺	퀺
퀻	퀻
퀼	퀼
퀽	퀽
퀾	퀾
퀿	퀿
큀	큀
큁	큁
큂	큂
큃	큃
큄	큄
큅	큅
큆	큆
큇	큇
큈	큈
큉	큉
큊	큊
큋	큋
큌	큌
큍	큍
큎	큎
큏	큏
큐	큐
큑	큑
큒	큒
큓	큓
큔	큔
큕	큕
큖	큖
큗	큗
큘	큘
큙	큙
큚	큚
큛	큛
큜	큜
큝	큝
큞	큞
큟	큟
큠	큠
큡	큡
큢	큢
큣	큣
큤	큤
큥	큥
큦	큦
큧	큧
큨	큨
큩	큩
큪	큪
큫	큫
크	크
큭	큭
큮	큮
큯	큯
큰	큰
큱	큱
큲	큲
큳	큳
클	클
큵	큵
큶	큶
큷	큷
큸	큸
큹	큹
큺	큺
큻	큻
큼	큼
큽	큽
큾	큾
큿	큿
킀	킀
킁	킁
킂	킂
킃	킃
킄	킄
킅	킅
킆	킆
킇	킇
킈	킈
킉	킉
킊	킊
킋	킋
킌	킌
킍	킍
킎	킎
킏	킏
킐	킐
킑	킑
킒	킒
킓	킓
킔	킔
킕	킕
킖	킖
킗	킗
킘	킘
킙	킙
킚	킚
킛	킛
킜	킜
킝	킝
킞	킞
킟	킟
킠	킠
킡	킡
킢	킢
킣	킣
키	키
킥	킥
킦	킦
킧	킧
킨	킨
킩	킩
킪	킪
킫	킫
킬	킬
킭	킭
킮	킮
킯	킯
킰	킰
킱	킱
킲	킲
킳	킳
킴	킴
킵	킵
킶	킶
킷	킷
킸	킸
킹	킹
킺	킺
킻	킻
킼	킼
킽	킽
킾	킾
킿	킿
타	타
탁	탁
탂	탂
탃	탃
탄	탄
탅	탅
탆	탆
탇	탇
탈	탈
탉	탉
탊	탊
탋	탋
탌	탌
탍	탍
탎	탎
탏	탏
탐	탐
탑	탑
탒	탒
탓	탓
탔	탔
탕	탕
탖	탖
탗	탗
탘	탘
탙	탙
탚	탚
탛	탛
태	태
택	택
탞	탞
탟	탟
탠	탠
탡	탡
탢	탢
탣	탣
탤	탤
탥	탥
탦	탦
탧	탧
탨	탨
탩	탩
탪	탪
탫	탫
탬	탬
탭	탭
탮	탮
탯	탯
탰	탰
탱	탱
탲	탲
탳	탳
탴	탴
탵	탵
탶	탶
탷	탷
탸	탸
탹	탹
탺	탺
탻	탻
탼	탼
탽	탽
탾	탾
탿	탿
턀	턀
턁	턁
턂	턂
턃	턃
턄	턄
턅	턅
턆	턆
턇	턇
턈	턈
턉	턉
턊	턊
턋	턋
턌	턌
턍	턍
턎	턎
턏	턏
턐	턐
턑	턑
턒	턒
턓	턓
턔	턔
턕	턕
턖	턖
턗	턗
턘	턘
턙	턙
턚	턚
턛	턛
턜	턜
턝	턝
턞	턞
턟	턟
턠	턠
턡	턡
턢	턢
턣	턣
턤	턤
턥	턥
턦	턦
턧	턧
턨	턨
턩	턩
턪	턪
턫	턫
턬	턬
턭	턭
턮	턮
턯	턯
터	터
턱	턱
턲	턲
턳	턳
턴	턴
턵	턵
턶	턶
턷	턷
털	털
턹	턹
턺	턺
턻	턻
턼	턼
턽	턽
턾	턾
턿	턿
텀	텀
텁	텁
텂	텂
텃	텃
텄	텄
텅	텅
텆	텆
텇	텇
텈	텈
텉	텉
텊	텊
텋	텋
테	테
텍	텍
텎	텎
텏	텏
텐	텐
텑	텑
텒	텒
텓	텓
텔	텔
텕	텕
텖	텖
텗	텗
텘	텘
텙	텙
텚	텚
텛	텛
템	템
텝	텝
텞	텞
텟	텟
텠	텠
텡	텡
텢	텢
텣	텣
텤	텤
텥	텥
텦	텦
텧	텧
텨	텨
텩	텩
텪	텪
텫	텫
텬	텬
텭	텭
텮	텮
텯	텯
텰	텰
텱	텱
텲	텲
텳	텳
텴	텴
텵	텵
텶	텶
텷	텷
텸	텸
텹	텹
텺	텺
텻	텻
텼	텼
텽	텽
텾	텾
텿	텿
톀	톀
톁	톁
톂	톂
톃	톃
톄	톄
톅	톅
톆	톆
톇	톇
톈	톈
톉	톉
톊	톊
톋	톋
톌	톌
톍	톍
톎	톎
톏	톏
톐	톐
톑	톑
톒	톒
톓	톓
톔	톔
톕	톕
톖	톖
톗	톗
톘	톘
톙	톙
톚	톚
톛	톛
톜	톜
톝	톝
톞	톞
톟	톟
토	토
톡	톡
톢	톢
톣	톣
톤	톤
톥	톥
톦	톦
톧	톧
톨	톨
톩	톩
톪	톪
톫	톫
톬	톬
톭	톭
톮	톮
톯	톯
톰	톰
톱	톱
톲	톲
톳	톳
톴	톴
통	통
톶	톶
톷	톷
톸	톸
톹	톹
톺	톺
톻	톻
톼	톼
톽	톽
톾	톾
톿	톿
퇀	퇀
퇁	퇁
퇂	퇂
퇃	퇃
퇄	퇄
퇅	퇅
퇆	퇆
퇇	퇇
퇈	퇈
퇉	퇉
퇊	퇊
퇋	퇋
퇌	퇌
퇍	퇍
퇎	퇎
퇏	퇏
퇐	퇐
퇑	퇑
퇒	퇒
퇓	퇓
퇔	퇔
퇕	퇕
퇖	퇖
퇗	퇗
퇘	퇘
퇙	퇙
퇚	퇚
퇛	퇛
퇜	퇜
퇝	퇝
퇞	퇞
퇟	퇟
퇠	퇠
퇡	퇡
퇢	퇢
퇣	퇣
퇤	퇤
퇥	퇥
퇦	퇦
퇧	퇧
퇨	퇨
퇩	퇩
퇪	퇪
퇫	퇫
퇬	퇬
퇭	퇭
퇮	퇮
퇯	퇯
퇰	퇰
퇱	퇱
퇲	퇲
퇳	퇳
퇴	퇴
퇵	퇵
퇶	퇶
퇷	퇷
퇸	퇸
퇹	퇹
퇺	퇺
퇻	퇻
퇼	퇼
퇽	퇽
퇾	퇾
퇿	퇿
툀	툀
툁	툁
툂	툂
툃	툃
툄	툄
툅	툅
툆	툆
툇	툇
툈	툈
툉	툉
툊	툊
툋	툋
툌	툌
툍	툍
툎	툎
툏	툏
툐	툐
툑	툑
툒	툒
툓	툓
툔	툔
툕	툕
툖	툖
툗	툗
툘	툘
툙	툙
툚	툚
툛	툛
툜	툜
툝	툝
툞	툞
툟	툟
툠	툠
툡	툡
툢	툢
툣	툣
툤	툤
툥	툥
툦	툦
툧	툧
툨	툨
툩	툩
툪	툪
툫	툫
투	투
툭	툭
툮	툮
툯	툯
툰	툰
툱	툱
툲	툲
툳	툳
툴	툴
툵	툵
툶	툶
툷	툷
툸	툸
툹	툹
툺	툺
툻	툻
툼	툼
툽	툽
툾	툾
툿	툿
퉀	퉀
퉁	퉁
퉂	퉂
퉃	퉃
퉄	퉄
퉅	퉅
퉆	퉆
퉇	퉇
퉈	퉈
퉉	퉉
퉊	퉊
퉋	퉋
퉌	퉌
퉍	퉍
퉎	퉎
퉏	퉏
퉐	퉐
퉑	퉑
퉒	퉒
퉓	퉓
퉔	퉔
퉕	퉕
퉖	퉖
퉗	퉗
퉘	퉘
퉙	퉙
퉚	퉚
퉛	퉛
퉜	퉜
퉝	퉝
퉞	퉞
퉟	퉟
퉠	퉠
퉡	퉡
퉢	퉢
퉣	퉣
퉤	퉤
퉥	퉥
퉦	퉦
퉧	퉧
퉨	퉨
퉩	퉩
퉪	퉪
퉫	퉫
퉬	퉬
퉭	퉭
퉮	퉮
퉯	퉯
퉰	퉰
퉱	퉱
퉲	퉲
퉳	퉳
퉴	퉴
퉵	퉵
퉶	퉶
퉷	퉷
퉸	퉸
퉹	퉹
퉺	퉺
퉻	퉻
퉼	퉼
퉽	퉽
퉾	퉾
퉿	퉿
튀	튀
튁	튁
튂	튂
튃	튃
튄	튄
튅	튅
튆	튆
튇	튇
튈	튈
튉	튉
튊	튊
튋	튋
튌	튌
튍	튍
튎	튎
튏	튏
튐	튐
튑	튑
튒	튒
튓	튓
튔	튔
튕	튕
튖	튖
튗	튗
튘	튘
튙	튙
튚	튚
튛	튛
튜	튜
튝	튝
튞	튞
튟	튟
튠	튠
튡	튡
튢	튢
튣	튣
튤	튤
튥	튥
튦	튦
튧	튧
튨	튨
튩	튩
튪	튪
튫	튫
튬	튬
튭	튭
튮	튮
튯	튯
튰	튰
튱	튱
튲	튲
튳	튳
튴	튴
튵	튵
튶	튶
튷	튷
트	트
특	특
튺	튺
튻	튻
튼	튼
튽	튽
튾	튾
튿	튿
틀	틀
틁	틁
틂	틂
틃	틃
틄	틄
틅	틅
틆	틆
틇	틇
틈	틈
틉	틉
틊	틊
틋	틋
틌	틌
틍	틍
틎	틎
틏	틏
틐	틐
틑	틑
틒	틒
틓	틓
틔	틔
틕	틕
틖	틖
틗	틗
틘	틘
틙	틙
틚	틚
틛	틛
틜	틜
틝	틝
틞	틞
틟	틟
틠	틠
틡	틡
틢	틢
틣	틣
틤	틤
틥	틥
틦	틦
틧	틧
틨	틨
틩	틩
틪	틪
틫	틫
틬	틬
틭	틭
틮	틮
틯	틯
티	티
틱	틱
틲	틲
틳	틳
틴	틴
틵	틵
틶	틶
틷	틷
틸	틸
틹	틹
틺	틺
틻	틻
틼	틼
틽	틽
틾	틾
틿	틿
팀	팀
팁	팁
팂	팂
팃	팃
팄	팄
팅	팅
팆	팆
팇	팇
팈	팈
팉	팉
팊	팊
팋	팋
파	파
팍	팍
팎	팎
팏	팏
판	판
팑	팑
팒	팒
팓	팓
팔	팔
팕	팕
팖	팖
팗	팗
팘	팘
팙	팙
팚	팚
팛	팛
팜	팜
팝	팝
팞	팞
팟	팟
팠	팠
팡	팡
팢	팢
팣	팣
팤	팤
팥	팥
팦	팦
팧	팧
패	패
팩	팩
팪	팪
팫	팫
팬	팬
팭	팭
팮	팮
팯	팯
팰	팰
팱	팱
팲	팲
팳	팳
팴	팴
팵	팵
팶	팶
팷	팷
팸	팸
팹	팹
팺	팺
팻	팻
팼	팼
팽	팽
팾	팾
팿	팿
퍀	퍀
퍁	퍁
퍂	퍂
퍃	퍃
퍄	퍄
퍅	퍅
퍆	퍆
퍇	퍇
퍈	퍈
퍉	퍉
퍊	퍊
퍋	퍋
퍌	퍌
퍍	퍍
퍎	퍎
퍏	퍏
퍐	퍐
퍑	퍑
퍒	퍒
퍓	퍓
퍔	퍔
퍕	퍕
퍖	퍖
퍗	퍗
퍘	퍘
퍙	퍙
퍚	퍚
퍛	퍛
퍜	퍜
퍝	퍝
퍞	퍞
퍟	퍟
퍠	퍠
퍡	퍡
퍢	퍢
퍣	퍣
퍤	퍤
퍥	퍥
퍦	퍦
퍧	퍧
퍨	퍨
퍩	퍩
퍪	퍪
퍫	퍫
퍬	퍬
퍭	퍭
퍮	퍮
퍯	퍯
퍰	퍰
퍱	퍱
퍲	퍲
퍳	퍳
퍴	퍴
퍵	퍵
퍶	퍶
퍷	퍷
퍸	퍸
퍹	퍹
퍺	퍺
퍻	퍻
퍼	퍼
퍽	퍽
퍾	퍾
퍿	퍿
펀	펀
펁	펁
펂	펂
펃	펃
펄	펄
펅	펅
펆	펆
펇	펇
펈	펈
펉	펉
펊	펊
펋	펋
펌	펌
펍	펍
펎	펎
펏	펏
펐	펐
펑	펑
펒	펒
펓	펓
펔	펔
펕	펕
펖	펖
펗	펗
페	페
펙	펙
펚	펚
펛	펛
펜	펜
펝	펝
펞	펞
펟	펟
펠	펠
펡	펡
펢	펢
펣	펣
펤	펤
펥	펥
펦	펦
펧	펧
펨	펨
펩	펩
펪	펪
펫	펫
펬	펬
펭	펭
펮	펮
펯	펯
펰	펰
펱	펱
펲	펲
펳	펳
펴	펴
펵	펵
펶	펶
펷	펷
편	편
펹	펹
펺	펺
펻	펻
펼	펼
펽	펽
펾	펾
펿	펿
폀	폀
폁	폁
폂	폂
폃	폃
폄	폄
폅	폅
폆	폆
폇	폇
폈	폈
평	평
폊	폊
폋	폋
폌	폌
폍	폍
폎	폎
폏	폏
폐	폐
폑	폑
폒	폒
폓	폓
폔	폔
폕	폕
폖	폖
폗	폗
폘	폘
폙	폙
폚	폚
폛	폛
폜	폜
폝	폝
폞	폞
폟	폟
폠	폠
폡	폡
폢	폢
폣	폣
폤	폤
폥	폥
폦	폦
폧	폧
폨	폨
폩	폩
폪	폪
폫	폫
포	포
폭	폭
폮	폮
폯	폯
폰	폰
폱	폱
폲	폲
폳	폳
폴	폴
폵	폵
폶	폶
폷	폷
폸	폸
폹	폹
폺	폺
폻	폻
폼	폼
폽	폽
폾	폾
폿	폿
퐀	퐀
퐁	퐁
퐂	퐂
퐃	퐃
퐄	퐄
퐅	퐅
퐆	퐆
퐇	퐇
퐈	퐈
퐉	퐉
퐊	퐊
퐋	퐋
퐌	퐌
퐍	퐍
퐎	퐎
퐏	퐏
퐐	퐐
퐑	퐑
퐒	퐒
퐓	퐓
퐔	퐔
퐕	퐕
퐖	퐖
퐗	퐗
퐘	퐘
퐙	퐙
퐚	퐚
퐛	퐛
퐜	퐜
퐝	퐝
퐞	퐞
퐟	퐟
퐠	퐠
퐡	퐡
퐢	퐢
퐣	퐣
퐤	퐤
퐥	퐥
퐦	퐦
퐧	퐧
퐨	퐨
퐩	퐩
퐪	퐪
퐫	퐫
퐬	퐬
퐭	퐭
퐮	퐮
퐯	퐯
퐰	퐰
퐱	퐱
퐲	퐲
퐳	퐳
퐴	퐴
퐵	퐵
퐶	퐶
퐷	퐷
퐸	퐸
퐹	퐹
퐺	퐺
퐻	퐻
퐼	퐼
퐽	퐽
퐾	퐾
퐿	퐿
푀	푀
푁	푁
푂	푂
푃	푃
푄	푄
푅	푅
푆	푆
푇	푇
푈	푈
푉	푉
푊	푊
푋	푋
푌	푌
푍	푍
푎	푎
푏	푏
푐	푐
푑	푑
푒	푒
푓	푓
푔	푔
푕	푕
푖	푖
푗	푗
푘	푘
푙	푙
푚	푚
푛	푛
표	표
푝	푝
푞	푞
푟	푟
푠	푠
푡	푡
푢	푢
푣	푣
푤	푤
푥	푥
푦	푦
푧	푧
푨	푨
푩	푩
푪	푪
푫	푫
푬	푬
푭	푭
푮	푮
푯	푯
푰	푰
푱	푱
푲	푲
푳	푳
푴	푴
푵	푵
푶	푶
푷	푷
푸	푸
푹	푹
푺	푺
푻	푻
푼	푼
푽	푽
푾	푾
푿	푿
풀	풀
풁	풁
풂	풂
풃	풃
풄	풄
풅	풅
풆	풆
풇	풇
품	품
풉	풉
풊	풊
풋	풋
풌	풌
풍	풍
풎	풎
풏	풏
풐	풐
풑	풑
풒	풒
풓	풓
풔	풔
풕	풕
풖	풖
풗	풗
풘	풘
풙	풙
풚	풚
풛	풛
풜	풜
풝	풝
풞	풞
풟	풟
풠	풠
풡	풡
풢	풢
풣	풣
풤	풤
풥	풥
풦	풦
풧	풧
풨	풨
풩	풩
풪	풪
풫	풫
풬	풬
풭	풭
풮	풮
풯	풯
풰	풰
풱	풱
풲	풲
풳	풳
풴	풴
풵	풵
풶	풶
풷	풷
풸	풸
풹	풹
풺	풺
풻	풻
풼	풼
풽	풽
풾	풾
풿	풿
퓀	퓀
퓁	퓁
퓂	퓂
퓃	퓃
퓄	퓄
퓅	퓅
퓆	퓆
퓇	퓇
퓈	퓈
퓉	퓉
퓊	퓊
퓋	퓋
퓌	퓌
퓍	퓍
퓎	퓎
퓏	퓏
퓐	퓐
퓑	퓑
퓒	퓒
퓓	퓓
퓔	퓔
퓕	퓕
퓖	퓖
퓗	퓗
퓘	퓘
퓙	퓙
퓚	퓚
퓛	퓛
퓜	퓜
퓝	퓝
퓞	퓞
퓟	퓟
퓠	퓠
퓡	퓡
퓢	퓢
퓣	퓣
퓤	퓤
퓥	퓥
퓦	퓦
퓧	퓧
퓨	퓨
퓩	퓩
퓪	퓪
퓫	퓫
퓬	퓬
퓭	퓭
퓮	퓮
퓯	퓯
퓰	퓰
퓱	퓱
퓲	퓲
퓳	퓳
퓴	퓴
퓵	퓵
퓶	퓶
퓷	퓷
퓸	퓸
퓹	퓹
퓺	퓺
퓻	퓻
퓼	퓼
퓽	퓽
퓾	퓾
퓿	퓿
픀	픀
픁	픁
픂	픂
픃	픃
프	프
픅	픅
픆	픆
픇	픇
픈	픈
픉	픉
픊	픊
픋	픋
플	플
픍	픍
픎	픎
픏	픏
픐	픐
픑	픑
픒	픒
픓	픓
픔	픔
픕	픕
픖	픖
픗	픗
픘	픘
픙	픙
픚	픚
픛	픛
픜	픜
픝	픝
픞	픞
픟	픟
픠	픠
픡	픡
픢	픢
픣	픣
픤	픤
픥	픥
픦	픦
픧	픧
픨	픨
픩	픩
픪	픪
픫	픫
픬	픬
픭	픭
픮	픮
픯	픯
픰	픰
픱	픱
픲	픲
픳	픳
픴	픴
픵	픵
픶	픶
픷	픷
픸	픸
픹	픹
픺	픺
픻	픻
피	피
픽	픽
픾	픾
픿	픿
핀	핀
핁	핁
핂	핂
핃	핃
필	필
핅	핅
핆	핆
핇	핇
핈	핈
핉	핉
핊	핊
핋	핋
핌	핌
핍	핍
핎	핎
핏	핏
핐	핐
핑	핑
핒	핒
핓	핓
핔	핔
핕	핕
핖	핖
핗	핗
하	하
학	학
핚	핚
핛	핛
한	한
핝	핝
핞	핞
핟	핟
할	할
핡	핡
핢	핢
핣	핣
핤	핤
핥	핥
핦	핦
핧	핧
함	함
합	합
핪	핪
핫	핫
핬	핬
항	항
핮	핮
핯	핯
핰	핰
핱	핱
핲	핲
핳	핳
해	해
핵	핵
핶	핶
핷	핷
핸	핸
핹	핹
핺	핺
핻	핻
핼	핼
핽	핽
핾	핾
핿	핿
햀	햀
햁	햁
햂	햂
햃	햃
햄	햄
햅	햅
햆	햆
햇	햇
했	했
행	행
햊	햊
햋	햋
햌	햌
햍	햍
햎	햎
햏	햏
햐	햐
햑	햑
햒	햒
햓	햓
햔	햔
햕	햕
햖	햖
햗	햗
햘	햘
햙	햙
햚	햚
햛	햛
햜	햜
햝	햝
햞	햞
햟	햟
햠	햠
햡	햡
햢	햢
햣	햣
햤	햤
향	향
햦	햦
햧	햧
햨	햨
햩	햩
햪	햪
햫	햫
햬	햬
햭	햭
햮	햮
햯	햯
햰	햰
햱	햱
햲	햲
햳	햳
햴	햴
햵	햵
햶	햶
햷	햷
햸	햸
햹	햹
햺	햺
햻	햻
햼	햼
햽	햽
햾	햾
햿	햿
헀	헀
헁	헁
헂	헂
헃	헃
헄	헄
헅	헅
헆	헆
헇	헇
허	허
헉	헉
헊	헊
헋	헋
헌	헌
헍	헍
헎	헎
헏	헏
헐	헐
헑	헑
헒	헒
헓	헓
헔	헔
헕	헕
헖	헖
헗	헗
험	험
헙	헙
헚	헚
헛	헛
헜	헜
헝	헝
헞	헞
헟	헟
헠	헠
헡	헡
헢	헢
헣	헣
헤	헤
헥	헥
헦	헦
헧	헧
헨	헨
헩	헩
헪	헪
헫	헫
헬	헬
헭	헭
헮	헮
헯	헯
헰	헰
헱	헱
헲	헲
헳	헳
헴	헴
헵	헵
헶	헶
헷	헷
헸	헸
헹	헹
헺	헺
헻	헻
헼	헼
헽	헽
헾	헾
헿	헿
혀	혀
혁	혁
혂	혂
혃	혃
현	현
혅	혅
혆	혆
혇	혇
혈	혈
혉	혉
혊	혊
혋	혋
혌	혌
혍	혍
혎	혎
혏	혏
혐	혐
협	협
혒	혒
혓	혓
혔	혔
형	형
혖	혖
혗	혗
혘	혘
혙	혙
혚	혚
혛	혛
혜	혜
혝	혝
혞	혞
혟	혟
혠	혠
혡	혡
혢	혢
혣	혣
혤	혤
혥	혥
혦	혦
혧	혧
혨	혨
혩	혩
혪	혪
혫	혫
혬	혬
혭	혭
혮	혮
혯	혯
혰	혰
혱	혱
혲	혲
혳	혳
혴	혴
혵	혵
혶	혶
혷	혷
호	호
혹	혹
혺	혺
혻	혻
혼	혼
혽	혽
혾	혾
혿	혿
홀	홀
홁	홁
홂	홂
홃	홃
홄	홄
홅	홅
홆	홆
홇	홇
홈	홈
홉	홉
홊	홊
홋	홋
홌	홌
홍	홍
홎	홎
홏	홏
홐	홐
홑	홑
홒	홒
홓	홓
화	화
확	확
홖	홖
홗	홗
환	환
홙	홙
홚	홚
홛	홛
활	활
홝	홝
홞	홞
홟	홟
홠	홠
홡	홡
홢	홢
홣	홣
홤	홤
홥	홥
홦	홦
홧	홧
홨	홨
황	황
홪	홪
홫	홫
홬	홬
홭	홭
홮	홮
홯	홯
홰	홰
홱	홱
홲	홲
홳	홳
홴	홴
홵	홵
홶	홶
홷	홷
홸	홸
홹	홹
홺	홺
홻	홻
홼	홼
홽	홽
홾	홾
홿	홿
횀	횀
횁	횁
횂	횂
횃	횃
횄	횄
횅	횅
횆	횆
횇	횇
횈	횈
횉	횉
횊	횊
횋	횋
회	회
획	획
횎	횎
횏	횏
횐	횐
횑	횑
횒	횒
횓	횓
횔	횔
횕	횕
횖	횖
횗	횗
횘	횘
횙	횙
횚	횚
횛	횛
횜	횜
횝	횝
횞	횞
횟	횟
횠	횠
횡	횡
횢	횢
횣	횣
횤	횤
횥	횥
횦	횦
횧	횧
효	효
횩	횩
횪	횪
횫	횫
횬	횬
횭	횭
횮	횮
횯	횯
횰	횰
횱	횱
횲	횲
횳	횳
횴	횴
횵	횵
횶	횶
횷	횷
횸	횸
횹	횹
횺	횺
횻	횻
횼	횼
횽	횽
횾	횾
횿	횿
훀	훀
훁	훁
훂	훂
훃	훃
후	후
훅	훅
훆	훆
훇	훇
훈	훈
훉	훉
훊	훊
훋	훋
훌	훌
훍	훍
훎	훎
훏	훏
훐	훐
훑	훑
훒	훒
훓	훓
훔	훔
훕	훕
훖	훖
훗	훗
훘	훘
훙	훙
훚	훚
훛	훛
훜	훜
훝	훝
훞	훞
훟	훟
훠	훠
훡	훡
훢	훢
훣	훣
훤	훤
훥	훥
훦	훦
훧	훧
훨	훨
훩	훩
훪	훪
훫	훫
훬	훬
훭	훭
훮	훮
훯	훯
훰	훰
훱	훱
훲	훲
훳	훳
훴	훴
훵	훵
훶	훶
훷	훷
훸	훸
훹	훹
훺	훺
훻	훻
훼	훼
훽	훽
훾	훾
훿	훿
휀	휀
휁	휁
휂	휂
휃	휃
휄	휄
휅	휅
휆	휆
휇	휇
휈	휈
휉	휉
휊	휊
휋	휋
휌	휌
휍	휍
휎	휎
휏	휏
휐	휐
휑	휑
휒	휒
휓	휓
휔	휔
휕	휕
휖	휖
휗	휗
휘	휘
휙	휙
휚	휚
휛	휛
휜	휜
휝	휝
휞	휞
휟	휟
휠	휠
휡	휡
휢	휢
휣	휣
휤	휤
휥	휥
휦	휦
휧	휧
휨	휨
휩	휩
휪	휪
휫	휫
휬	휬
휭	휭
휮	휮
휯	휯
휰	휰
휱	휱
휲	휲
휳	휳
휴	휴
휵	휵
휶	휶
휷	휷
휸	휸
휹	휹
휺	휺
휻	휻
휼	휼
휽	휽
휾	휾
휿	휿
흀	흀
흁	흁
흂	흂
흃	흃
흄	흄
흅	흅
흆	흆
흇	흇
흈	흈
흉	흉
흊	흊
흋	흋
흌	흌
흍	흍
흎	흎
흏	흏
흐	흐
흑	흑
흒	흒
흓	흓
흔	흔
흕	흕
흖	흖
흗	흗
흘	흘
흙	흙
흚	흚
흛	흛
흜	흜
흝	흝
흞	흞
흟	흟
흠	흠
흡	흡
흢	흢
흣	흣
흤	흤
흥	흥
흦	흦
흧	흧
흨	흨
흩	흩
흪	흪
흫	흫
희	희
흭	흭
흮	흮
흯	흯
흰	흰
흱	흱
흲	흲
흳	흳
흴	흴
흵	흵
흶	흶
흷	흷
흸	흸
흹	흹
흺	흺
흻	흻
흼	흼
흽	흽
흾	흾
흿	흿
힀	힀
힁	힁
힂	힂
힃	힃
힄	힄
힅	힅
힆	힆
힇	힇
히	히
힉	힉
힊	힊
힋	힋
힌	힌
힍	힍
힎	힎
힏	힏
힐	힐
힑	힑
힒	힒
힓	힓
힔	힔
힕	힕
힖	힖
힗	힗
힘	힘
힙	힙
힚	힚
힛	힛
힜	힜
힝	힝
힞	힞
힟	힟
힠	힠
힡	힡
힢	힢
힣	힣
힤	힤
힥	힥
힦	힦
힧	힧
힨	힨
힩	힩
힪	힪
힫	힫
힬	힬
힭	힭
힮	힮
힯	힯
ힰ	ힰ
ힱ	ힱ
ힲ	ힲ
ힳ	ힳ
ힴ	ힴ
ힵ	ힵ
ힶ	ힶ
ힷ	ힷ
ힸ	ힸ
ힹ	ힹ
ힺ	ힺ
ힻ	ힻ
ힼ	ힼ
ힽ	ힽ
ힾ	ힾ
ힿ	ힿ
ퟀ	ퟀ
ퟁ	ퟁ
ퟂ	ퟂ
ퟃ	ퟃ
ퟄ	ퟄ
ퟅ	ퟅ
ퟆ	ퟆ
퟇	퟇
퟈	퟈
퟉	퟉
퟊	퟊
ퟋ	ퟋ
ퟌ	ퟌ
ퟍ	ퟍ
ퟎ	ퟎ
ퟏ	ퟏ
ퟐ	ퟐ
ퟑ	ퟑ
ퟒ	ퟒ
ퟓ	ퟓ
ퟔ	ퟔ
ퟕ	ퟕ
ퟖ	ퟖ
ퟗ	ퟗ
ퟘ	ퟘ
ퟙ	ퟙ
ퟚ	ퟚ
ퟛ	ퟛ
ퟜ	ퟜ
ퟝ	ퟝ
ퟞ	ퟞ
ퟟ	ퟟ
ퟠ	ퟠ
ퟡ	ퟡ
ퟢ	ퟢ
ퟣ	ퟣ
ퟤ	ퟤ
ퟥ	ퟥ
ퟦ	ퟦ
ퟧ	ퟧ
ퟨ	ퟨ
ퟩ	ퟩ
ퟪ	ퟪ
ퟫ	ퟫ
ퟬ	ퟬ
ퟭ	ퟭ
ퟮ	ퟮ
ퟯ	ퟯ
ퟰ	ퟰ
ퟱ	ퟱ
ퟲ	ퟲ
ퟳ	ퟳ
ퟴ	ퟴ
ퟵ	ퟵ
ퟶ	ퟶ
ퟷ	ퟷ
ퟸ	ퟸ
ퟹ	ퟹ
ퟺ	ퟺ
ퟻ	ퟻ
퟼	퟼
퟽	퟽
퟾	퟾
퟿	퟿
	
	
	
	
	
	
	
	
	
	
	
	
	
	
	
	
	
	
	
	
	
	
	
	
	
	
	
	
	
	
	
	
	
	
	
	
	
	
	
	
	
	
	
	
	
	
	
	
	
	
	
	
	
	
	
	
	
	
	
	
	
	
	
	
	
	
	
	
	
	
	
	
	
	
	
	
	
	
	
	
	
	
	
	
	
	
	
	
	
	
	
	
	
	
	
	
	
	
	
	
	
	
	
	
	
	
	
	
	
	
	
	
	
	
	
	
	
	
	
	
	
	
	
	
	
	
	
	
	
	
	
	
	
	
	
	
	
	
	
	
	
	
	
	
	
	
	
	
	
	
	
	
	
	
	
	
	
	
	
	
	
	
	
	
	
	
	
	
	
	
	
	
	
	
	
	
	
	
	
	
	
	
	
	
	
	
	
	
	
	
	
	
	
	
	
	
	
	
	
	
	
	
	
	
	
	
	
	
	
	
	
	
	
	
	
	
	
	
	
	
	
	
	
	
	
	
	
	
	
	
	
	
	
	
	
	
	
	
	
	
	
	
	
	
	
	
	
	
	
	
	
	
	
	
	
	
	
	
	
	
	
	
	
	
	
	
	
	
	
	
	
	
	
	
	
	
	
	
	
	
	
	
	
	
	
	
	
	
	
	
	
	
	
	
	
	
	
	
	
	
	
	
	
	
	
	
	
	
	
	
	
	
	
	
	
	
	
	
	
	
	
	
	
	
	
	
	
	
	
	
	
	
	
	
	
	
	
	
	
	
	
	
	
	
	
	
	
	
	
	
	
	
	
	
	
	
	
	
	
	
	
	
	
	
	
	
	
	
	
	
	
	
	
	
	
	
	
	
	
	
	
	
	
	
	
	
	
	
	
	
	
	
	
	
	
	
	
	
	
	
	
	
	
	
	
	
	
	
	
	
	
	
	
	
	
	
	
	
	
	
	
	
	
	
	
	
	
	
	
	
	
	
	
	
	
	
	
	
	
	
	
	
	
	
	
	
	
	
	
	
	
	
	
	
	
	
	
	
	
	
	
	
	
	
	
	
	
	
	
	
	
	
	
	
	
	
	
	
	
	
	
	
	
	
	
	
	
	
	
	
	
	
	
	
	
	
	
	
	
	
	
	
	
	
	
	
	
	
	
	
	
	
	
	
	
	
	
	
	
	
	
	
	
	
	
	
	
	
	
	
	
	
	
	
	
	
	
	
	
	
	
	
	
	
	
	
	
	
	
	
	
	
	
	
	
	
	
	
	
	
	
	
	
	
	
	
	
	
	
	
	
	
	
	
	
	
	
	
	
	
	
	
	
	
	
	
	
	
	
	
	
	
	
	
	
	
	
	
	
	
	
	
	
	
	
	
	
	
	
	
	
	
	
	
	
	
	
	
	
	
	
	
	
	
	
	
	
	
	
	
	
	
	
	
	
	
	
	
	
	
	
	
	
	
	
	
	
	
	
	
	
	
	
	
	
	
	
	
	
	
	
	
	
	
	
	
	
	
	
	
	
	
	
	
	
	
	
	
	
	
	
	
	
	
	
	
	
	
	
	
	
	
	
	
	
	
	
	
	
	
	
	
	
	
	
	
	
	
	
	
	
	
	
	
	
	
	
	
	
	
	
	
	
	
	
	
	
	
	
	
	
	
	
	
	
	
	
	
	
	
	
	
	
	
	
	
	
	
	
	
	
	
	
	
	
	
	
	
	
	
	
	
	
	
	
	
	
	
	
	
	
	
	
	
	
	
	
	
	
	
	
	
	
	
	
	
	
	
	
	
	
	
	
	
	
	
	
	
	
	
	
	
	
	
	
	
	
	
	
	
	
	
	
	
	
	
	
	
	
	
	
	
	
	
	
	
	
	
	
	
	
	
	
	
	
	
	
	
	
	
	
	
	
	
	
	
	
	
	
	
	
	
	
	
	
	
	
	
	
	
	
	
	
	
	
	
	
	
	
	
	
	
	
	
	
	
	
	
	
	
	
	
	
	
	
	
	
	
	
	
	
	
	
	
	
	
	
	
	
	
	
	
	
	
	
	
	
	
	
	
	
	
	
	
	
	
	
	
	
	
	
	
	
	
	
	
	
	
	
	
	
	
	
	
	
	
	
	
	
	
	
	
	
	
	
	
	
	
	
	
	
	
	
	
	
	
	
	
	
	
	
	
	
	
	
	
	
	
	
	
	
	
	
	
	
	
	
	
	
	
	
	
	
	
	
	
	
	
	
	
	
	
	
	
	
	
	
	
	
	
	
	
	
	
	
	
	
	
	
	
	
	
	
	
	
	
	
	
	
	
	
	
	
	
	
	
	
	
	
	
	
	
	
	
	
	
	
	
	
	
	
	
	
	
	
	
	
	
	
	
	
	
	
	
	
	
	
	
	
	
	
	
	
	
	
	
	
	
	
	
	
	
	
	
	
	
	
	
	
	
	
	
	
	
	
	
	
	
	
	
	
	
	
	
	
	
	
	
	
	
	
	
	
	
	
	
	
	
	
	
	
	
	
	
	
	
	
	
	
	
	
	
	
	
	
	
	
	
	
	
	
	
	
	
	
	
	
	
	
	
	
	
	
	
	
	
	
	
	
	
	
	
	
	
	
	
	
	
	
	
	
	
	
	
	
	
	
	
	
	
	
	
	
	
	
	
	
	
	
	
	
	
	
	
	
	
	
	
	
	
	
	
	
	
	
	
	
	
	
	
	
	
	
	
	
	
	
	
	
	
	
	
	
	
	
	
	
	
	
	
	
	
	
	
	
	
	
	
	
	
	
	
	
	
	
	
	
	
	
	
	
	
	
	
	
	
	
	
	
	
	
	
	
	
	
	
	
	
	
	
	
	
	
	
	
	
	
	
	
	
	
	
	
	
	
	
	
	
	
	
	
	
	
	
	
	
	
	
	
	
	
	
	
	
	
	
	
	
	
	
	
	
	
	
	
	
	
	
	
	
	
	
	
	
	
	
	
	
	
	
	
	
	
	
	
	
	
	
	
	
	
	
	
	
	
	
	
	
	
	
	
	
	
	
	
	
	
	
	
	
	
	
	
	
	
	
	
	
	
	
	
	
	
	
	
	
	
	
	
	
	
	
	
	
	
	
	
	
	
	
	
	
	
	
	
	
	
	
	
	
	
	
	
	
	
	
	
	
	
	
	
	
	
	
	
	
	
	
	
	
	
	
	
	
	
	
	
	
	
	
	
	
	
	
	
	
	
	
	
	
	
	
	
	
	
	
	
	
	
	
	
	
	
	
	
	
	
	
	
	
	
	
	
	
	
	
	
	
	
	
	
	
	
	
	
	
	
	
	
	
	
	
	
	
	
	
	
	
	
	
	
	
	
	
	
	
	
	
	
	
	
	
	
	
	
	
	
	
	
	
	
	
	
	
	
	
	
	
	
	
	
	
	
	
	
	
	
	
	
	
	
	
	
	
	
	
	
	
	
	
	
	
	
	
	
	
	
	
	
	
	
	
	
	
	
	
	
	
	
	
	
	
	
	
	
	
	
	
	
	
	
	
	
	
	
	
	
	
	
	
	
	
	
	
	
	
	
	
	
	
	
	
	
	
	
	
	
	
	
	
	
	
	
	
	
	
	
	
	
	
	
	
	
	
	
	
	
	
	
	
	
	
	
	
	
	
	
	
	
	
	
	
	
	
	
	
	
	
	
	
	
	
	
	
	
	
	
	
	
	
	
	
	
	
	
	
	
	
	
	
	
	
	
	
	
	
	
	
	
	
	
	
	
	
	
	
	
	
	
	
	
	
	
	
	
	
	
	
	
	
	
	
	
	
	
	
	
	
	
	
	
	
	
	
	
	
	
	
	
	
	
	
	
	
	
	
	
	
	
	
	
	
	
	
	
	
	
	
	
	
	
	
	
	
	
	
	
	
	
	
	
	
	
	
	
	
	
	
	
	
	
	
	
	
	
	
	
	
	
	
	
	
	
	
	
	
	
	
	
	
	
	
	
	
	
	
	
	
	
	
	
	
	
	
	
	
	
	
	
	
	
	
	
	
	
	
	
	
	
	
	
	
	
	
	
	
	
	
	
	
	
	
	
	
	
	
	
	
	
	
	
	
	
	
	
	
	
	
	
	
	
	
	
	
	
	
	
	
	
	
	
	
	
	
	
	
	
	
	
	
	
	
	
	
	
	
	
	
	
	
	
	
	
	
	
	
	
	
	
	
	
	
	
	
	
	
	
	
	
	
	
	
	
	
	
	
	
	
	
	
	
	
	
	
	
	
	
	
	
	
	
	
	
	
	
	
	
	
	
	
	
	
	
	
	
	
	
	
	
	
	
	
	
	
	
	
	
	
	
	
	
	
	
	
	
	
	
	
	
	
	
	
	
	
	
	
	
	
	
	
	
	
	
	
	
	
	
	
	
	
	
	
	
	
	
	
	
	
	
	
	
	
	
	
	
	
	
	
	
	
	
	
	
	
	
	
	
	
	
	
	
	
	
	
	
	
	
	
	
	
	
	
	
	
	
	
	
	
	
	
	
	
	
	
	
	
	
	
	
	
	
	
	
	
	
	
	
	
	
	
	
	
	
	
	
	
	
	
	
	
	
	
	
	
	
	
	
	
	
	
	
	
	
	
	
	
	
	
	
	
	
	
	
	
	
	
	
	
	
	
	
	
	
	
	
	
	
	
	
	
	
	
	
	
	
	
	
	
	
	
	
	
	
	
	
	
	
	
	
	
	
	
	
	
	
	
	
	
	
	
	
	
	
	
	
	
	
	
	
	
	
	
	
	
	
	
	
	
	
	
	
	
	
	
	
	
	
	
	
	
	
	
	
	
	
	
	
	
	
	
	
	
	
	
	
	
	
	
	
	
	
	
	
	
	
	
	
	
	
	
	
	
	
	
	
	
	
	
	
	
	
	
	
	
	
	
	
	
	
	
	
	
	
	
	
	
	
	
	
	
	
	
	
	
	
	
	
	
	
	
	
	
	
	
	
	
	
	
	
	
	
	
	
	
	
	
	
	
	
	
	
	
	
	
	
	
	
	
	
	
	
	
	
	
	
	
	
	
	
	
	
	
	
	
	
	
	
	
	
	
	
	
	
	
	
	
	
	
	
	
	
	
	
	
	
	
	
	
	
	
	
	
	
	
	
	
	
	
	
	
	
	
	
	
	
	
	
	
	
	
	
	
	
	
	
	
	
	
	
	
	
	
	
	
	
	
	
	
	
	
	
	
	
	
	
	
	
	
	
	
	
	
	
	
	
	
	
	
	
	
	
	
	
	
	
	
	
	
	
	
	
	
	
	
	
	
	
	
	
	
	
	
	
	
	
	
	
	
	
	
	
	
	
	
	
	
	
	
	
	
	
	
	
	
	
	
	
	
	
	
	
	
	
	
	
	
	
	
	
	
	
	
	
	
	
	
	
	
	
	
	
	
	
	
	
	
	
	
	
	
	
	
	
	
	
	
	
	
	
	
	
	
	
	
	
	
	
	
	
	
	
	
	
	
	
	
	
	
	
	
	
	
	
	
	
	
	
	
	
	
	
	
	
	
	
	
	
	
	
	
	
	
	
	
	
	
	
	
	
	
	
	
	
	
	
	
	
	
	
	
	
	
	
	
	
	
	
	
	
	
	
	
	
	
	
	
	
	
	
	
	
	
	
	
	
	
	
	
	
	
	
	
	
	
	
	
	
	
	
	
	
	
	
	
	
	
	
	
	
	
	
	
	
	
	
	
	
	
	
	
	
	
	
	
	
	
	
	
	
	
	
	
	
	
	
	
	
	
	
	
	
	
	
	
	
	
	
	
	
	
	
	
	
	
	
	
	
	
	
	
	
	
	
	
	
	
	
	
	
	
	
	
	
	
	
	
	
	
	
	
	
	
	
	
	
	
	
	
	
	
	
	
	
	
	
	
	
	
	
	
	
	
	
	
	
	
	
	
	
	
	
	
	
	
	
	
	
	
	
	
	
	
	
	
	
	
	
	
	
	
	
	
	
	
	
	
	
	
	
	
	
	
	
	
	
	
	
	
	
	
	
	
	
	
	
	
	
	
	
	
	
	
	
	
	
	
	
	
	
	
	
	
	
	
	
	
	
	
	
	
	
	
	
	
	
	
	
	
	
	
	
	
	
	
	
	
	
	
	
	
	
	
	
	
	
	
	
	
	
	
	
	
	
	
	
	
	
	
	
	
	
	
	
	
	
	
	
	
	
	
	
	
	
	
	
	
	
	
	
	
	
	
	
	
	
	
	
	
	
	
	
	
	
	
	
	
	
	
	
	
	
	
	
	
	
	
	
	
	
	
	
	
	
	
	
	
	
	
	
	
	
	
	
	
	
	
	
	
	
	
	
	
	
	
	
	
	
	
	
	
	
	
	
	
	
	
	
	
	
	
	
	
	
	
	
	
	
	
	
	
	
	
	
	
	
	
	
	
	
	
	
	
	
	
	
	
	
	
	
	
	
	
	
	
	
	
	
	
	
	
	
	
	
	
	
	
	
	
	
	
	
	
	
	
	
	
	
	
	
	
	
	
	
	
	
	
	
	
	
	
	
	
	
	
	
	
	
	
	
	
	
	
	
	
	
	
	
	
	
	
	
	
	
	
	
	
	
	
	
	
	
	
	
	
	
	
	
	
	
	
	
	
	
	
	
	
	
	
	
	
	
	
	
	
	
	
	
	
	
	
	
	
	
	
	
	
	
	
	
	
	
	
	
	
	
	
	
	
	
	
	
	
	
	
	
	
	
	
	
	
	
	
	
	
	
	
	
	
	
	
	
	
	
	
	
	
	
	
	
	
	
	
	
	
	
	
	
	
	
	
	
	
	
	
	
	
	
	
	
	
	
	
	
	
	
	
	
	
	
	
	
	
	
	
	
	
	
	
	
	
	
	
	
	
	
	
	
	
	
	
	
	
	
	
	
	
	
	
	
	
	
	
	
	
	
	
	
	
	
	
	
	
	
	
	
	
	
	
	
	
	
	
	
	
	
	
	
	
	
	
	
	
	
	
	
	
	
	
	
	
	
	
	
	
	
	
	
	
	
	
	
	
	
	
	
	
	
	
	
	
	
	
	
	
	
	
	
	
	
	
	
	
	
	
	
	
	
	
	
	
	
	
	
	
	
	
	
	
	
	
	
	
	
	
	
	
	
	
	
	
	
	
	
	
	
	
	
	
	
	
	
	
	
	
	
	
	
	
	
	
	
	
	
	
	
	
	
	
	
	
	
	
	
	
	
	
	
	
	
	
	
	
	
	
	
	
	
	
	
	
	
	
	
	
	
	
	
	
	
	
	
	
	
	
	
	
	
	
	
	
	
	
	
	
	
	
	
	
	
	
	
	
	
	
	
	
	
	
	
	
	
	
	
	
	
	
	
	
	
	
	
	
	
	
	
	
	
	
	
	
	
	
	
	
	
	
	
	
	
	
	
	
	
	
	
	
	
	
	
	
	
	
	
	
	
	
	
	
	
	
	
	
	
	
	
	
	
	
	
	
	
	
	
	
	
	
	
	
	
	
	
	
	
	
	
	
	
	
	
	
	
	
	
	
	
	
	
	
	
	
	
	
	
	
	
	
	
	
	
	
	
	
	
	
	
	
	
	
	
	
	
	
	
	
	
	
	
	
	
	
	
	
	
	
	
	
	
	
	
	
	
	
	
	
	
	
	
	
	
	
	
	
	
	
	
	
	
	
	
	
	
	
	
	
	
	
	
	
	
	
	
	
	
	
	
	
	
	
	
	
	
	
	
	
	
	
	
	
	
	
	
	
	
	
	
	
	
	
	
	
	
	
	
	
	
	
	
	
	
	
	
	
	
	
	
	
	
	
	
	
	
	
	
	
	
	
	
	
	
	
	
	
	
	
	
	
	
	
	
	
	
	
	
	
	
	
	
	
	
	
	
	
	
	
	
	
	
	
	
	
	
	
	
	
	
	
	
	
	
	
	
	
	
	
	
	
	
	
	
	
	
	
	
	
	
	
	
	
	
	
	
	
	
	
	
	
	
	
	
	
	
	
	
	
	
	
	
	
	
	
	
	
	
	
	
	
	
	
	
	
	
	
	
	
	
	
	
	
	
	
	
	
	
	
	
	
	
	
	
	
	
	
	
	
	
	
	
	
	
	
	
	
	
	
	
	
	
	
	
	
	
	
	
	
	
	
	
	
	
	
	
	
	
	
	
	
	
	
	
	
	
	
	
	
	
	
	
	
	
	
	
	
	
	
	
	
	
	
	
	
	
	
	
	
	
	
	
	
	
	
	
	
	
	
	
	
	
	
	
	
	
	
	
	
	
	
	
	
	
	
	
	
	
	
	
	
	
	
	
	
	
	
	
	
	
	
	
	
	
	
	
	
	
	
	
	
	
	
	
	
	
	
	
	
	
	
	
	
	
	
	
	
	
	
	
	
	
	
	
	
	
	
	
	
	
	
	
	
	
	
	
	
	
	
	
	
	
	
	
	
	
	
	
	
	
	
	
	
	
	
	
	
	
	
	
	
	
	
	
	
	
	
	
	
	
	
	
	
	
	
	
	
	
	
	
	
	
	
	
	
	
	
	
	
	
	
	
	
	
	
	
	
	
	
	
	
	
	
	
	
	
	
	
	
	
	
	
	
	
	
	
	
	
	
	
	
	
	
	
	
	
	
	
	
	
	
	
	
	
	
	
	
	
	
	
	
	
	
	
	
	
	
	
	
	
	
	
	
	
	
	
	
	
	
	
	
	
	
	
	
	
	
	
	
	
	
	
	
	
	
	
	
	
	
	
	
	
	
	
	
	
	
	
	
	
	
	
	
	
	
	
	
	
	
	
	
	
	
	
	
	
	
	
	
	
	
	
	
	
	
	
	
	
	
	
	
	
	
	
	
	
	
	
	
	
	
	
	
	
	
	
	
	
	
	
	
	
	
	
	
	
	
	
	
	
	
	
	
	
	
	
	
	
	
	
	
	
	
	
	
	
	
	
	
	
	
	
	
	
	
	
	
	
	
	
	
	
	
	
	
	
	
	
	
	
	
	
	
	
	
	
	
	
	
	
	
	
	
	
	
	
	
	
	
	
	
	
	
	
	
	
	
	
	
	
	
	
	
	
	
	
	
	
	
	
	
	
	
	
	
	
	
	
	
	
	
	
	
	
	
	
	
	
	
	
	
	
	
	
	
	
	
	
	
	
	
	
	
	
	
	
	
	
	
	
	
	
	
	
	
	
	
	
	
	
	
	
	
	
	
	
	
	
	
	
	
	
	
	
	
	
	
	
	
	
	
	
	
	
	
	
	
	
	
	
	
	
	
	
	
	
	
	
	
	
	
	
	
	
	
	
	
	
	
	
	
	
	
	
	
	
	
	
	
	
	
	
	
	
	
	
	
	
	
	
	
	
	
	
	
	
	
	
	
	
	
	
	
	
	
	
	
	
	
	
	
	
	
	
	
	
	
	
	
	
	
	
	
	
	
	
	
	
	
	
	
	
	
	
	
	
	
	
	
	
	
	
	
	
	
	
	
	
	
	
	
	
	
	
	
	
	
	
	
	
	
	
	
	
	
	
	
	
	
	
	
	
	
	
	
	
	
	
	
	
	
	
	
	
	
	
	
	
	
	
	
	
	
	
	
	
	
	
	
	
	
	
	
	
	
	
	
	
	
	
	
	
	
	
	
	
	
	
	
	
	
	
	
	
	
	
	
	
	
	
	
	
	
	
	
	
	
	
	
	
	
	
	
	
	
	
	
	
	
	
	
	
	
	
	
	
	
	
	
	
	
	
	
	
	
	
	
	
	
	
	
	
	
	
	
	
	
	
	
	
	
	
	
	
	
	
	
	
	
	
	
	
	
	
	
	
	
	
	
	
	
	
	
	
	
	
	
	
	
	
	
	
	
	
	
	
	
	
	
	
	
	
	
	
	
	
	
	
	
	
	
	
	
	
	
	
	
	
	
	
	
	
	
	
	
	
	
	
	
	
	
	
	
	
	
	
	
	
	
	
	
	
	
	
	
	
	
	
	
	
	
	
	
	
	
	
	
	
	
	
	
	
	
	
	
	
	
	
	
	
	
	
	
	
	
	
	
	
	
	
	
	
	
	
	
	
	
	
	
	
	
	
	
	
	
	
	
	
	
	
	
	
	
	
	
	
	
	
	
	
	
	
	
	
	
	
	
	
	
	
	
	
	
	
	
	
	
	
	
	
	
	
	
	
	
	
	
	
	
	
	
	
	
	
	
	
	
	
	
	
	
	
	
	
	
	
	
	
	
	
	
	
	
	
	
	
	
	
	
	
	
	
	
	
	
	
	
	
	
	
	
	
	
	
	
	
	
	
	
	
	
	
	
	
	
	
	
	
	
	
	
	
	
	
	
	
	
	
	
	
	
	
	
	
	
	
	
	
	
	
	
	
	
	
	
	
	
	
	
	
	
	
	
	
	
	
	
	
	
	
	
	
	
	
	
	
	
	
	
	
	
	
	
	
	
	
	
	
	
	
	
	
	
	
	
	
	
	
	
	
	
	
	
	
	
	
	
	
	
	
	
	
	
	
	
	
	
	
	
	
	
	
	
	
	
	
	
	
	
	
	
	
	
	
	
	
	
	
	
	
	
	
	
	
	
	
	
	
	
	
	
	
	
	
	
	
	
	
	
	
	
	
	
	
	
	
	
	
	
	
	
	
	
	
	
	
	
	
	
	
	
	
	
	
	
	
	
	
	
	
	
	
	
	
	
	
	
	
	
	
	
	
	
	
	
	
	
	
	
	
	
	
	
	
	
	
	
	
	
	
	
	
	
	
	
	
	
	
	
	
	
	
	
	
	
	
	
	
	
	
	
	
	
	
	
	
	
	
	
	
	
	
	
	
	
	
	
	
	
	
	
	
	
	
	
	
	
	
	
	
	
	
	
	
	
	
	
	
	
	
	
	
	
	
	
	
	
	
	
	
	
	
	
	
	
	
	
	
	
	
	
	
	
	
	
	
	
	
	
	
	
	
	
	
	
	
	
	
	
	
	
	
	
	
	
	
	
	
	
	
	
	
	
	
	
	
	
	
	
	
	
	
	
	
	
	
	
	
	
	
	
	
	
	
	
	
	
	
	
	
	
	
	
	
	
	
	
	
	
	
	
	
	
	
	
	
	
	
	
	
	
	
	
	
	
	
	
	
	
	
	
	
	
	
	
	
	
	
	
	
	
	
	
	
	
	
	
	
	
	
	
	
	
	
	
	
	
	
	
	
	
	
	
	
	
	
	
	
	
	
	
	
	
	
	
	
	
	
	
	
	
	
	
	
	
	
	
	
	
	
	
	
	
	
	
	
	
	
	
	
	
	
	
	
	
	
	
	
	
	
	
	
	
	
	
	
	
	
	
	
	
	
	
	
	
	
	
	
	
	
	
	
	
	
	
	
	
	
	
	
	
	
	
	
	
	
	
	
	
	
	
	
	
	
	
	
	
	
	
	
	
	
	
	
	
	
	
	
	
	
	
	
	
	
	
	
	
	
	
	
	
	
	
	
	
	
	
	
	
	
	
	
	
	
	
	
	
	
	
	
	
	
	
	
	
	
	
	
	
	
	
	
	
	
	
	
	
	
	
	
	
	
	
	
	
	
	
	
	
	
	
	
	
	
	
	
	
	
	
	
	
	
	
	
	
	
	
	
	
	
	
	
	
	
	
	
	
	
	
	
	
	
	
	
	
	
	
	
	
	
	
	
	
	
	
	
	
	
	
	
	
	
	
	
	
	
	
	
	
	
	
	
	
	
	
	
	
	
	
	
	
	
	
	
	
	
	
	
	
	
	
	
	
	
	
	
	
	
	
	
	
	
	
	
	
	
	
	
	
	
	
	
	
	
	
	
	
	
	
	
	
	
	
	
	
	
	
	
	
	
	
	
	
	
	
	
	
	
	
	
	
	
	
	
	
	
	
	
	
	
	
	
	
	
	
	
	
	
	
	
	
	
	
	
	
	
	
	
	
	
	
	
	
	
	
	
	
	
	
	
	
	
	
	
	
	
	
	
	
	
	
	
	
	
	
	
	
	
	
	
	
	
	
	
	
	
	
	
	
	
	
	
	
	
	
	
	
	
	
	
	
	
	
	
	
	
	
	
	
	
	
	
	
	
	
	
	
	
	
	
	
	
	
	
	
	
	
	
	
	
	
	
	
	
	
	
	
	
	
	
	
	
	
	
	
	
	
	
	
	
	
	
	
	
	
	
	
	
	
	
	
	
	
	
	
	
	
	
	
	
	
	
	
	
	
	
	
	
	
	
	
	
	
	
	
	
	
	
	
	
	
	
	
	
	
	
	
	
	
	
	
	
	
	
	
	
	
	
	
	
	
	
	
	
	
	
	
	
	
	
	
	
	
	
	
	
	
	
	
	
	
	
	
	
	
	
	
	
	
	
	
	
	
	
	
	
	
	
	
	
	
	
	
	
	
	
	
	
	
	
	
	
	
	
	
	
	
	
	
	
	
	
	
	
	
	
	
	
	
	
	
	
	
	
	
	
	
	
	
	
	
	
	
	
	
	
	
	
	
	
	
	
	
	
	
	
	
	
	
	
	
	
	
	
	
	
	
	
	
	
	
	
	
	
	
	
	
	
	
	
	
	
	
	
	
	
	
	
	
	
	
	
	
	
	
	
	
	
	
	
	
	
	
	
	
	
	
	
	
	
	
	
	
	
	
	
	
	
	
	
	
	
	
	
	
	
	
	
	
	
	
	
	
	
	
	
	
	
	
	
	
	
	
	
	
	
	
	
	
	
	
	
	
	
	
	
	
	
	
	
	
	
	
	
	
	
	
	
	
	
	
	
	
	
	
	
	
	
	
	
	
	
	
	
	
	
	
	
	
	
	
	
	
	
	
	
	
	
	
	
	
	
	
	
	
	
	
	
	
	
	
	
	
	
	
	
	
	
	
	
	
	
	
	
	
	
	
	
	
	
	
	
	
	
	
	
	
	
	
	
	
	
	
	
	
	
	
	
	
	
	
	
	
	
	
	
	
	
	
	
	
	
	
	
	
	
	
	
	
	
	
	
	
	
	
	
	
	
	
	
	
	
	
	
	
	
	
	
	
	
	
	
	
	
	
	
	
	
	
	
	
	
	
	
	
	
	
	
	
	
	
	
	
	
	
	
	
	
	
	
	
	
	
	
	
	
	
	
	
	
	
	
	
	
	
	
	
	
	
	
	
	
	
	
	
	
	
	
	
	
	
	
	
	
	
	
	
	
	
	
	
	
	
	
	
	
	
	
	
	
	
	
	
	
	
	
	
	
	
	
	
	
	
	
	
	
	
	
	
	
	
	
	
	
	
	
	
	
	
	
	
	
	
	
	
	
	
	
	
	
	
	
	
	
	
	
	
	
	
	
	
	
	
	
	
	
	
	
	
	
	
	
	
	
	
	
	
	
	
	
	
	
	
	
	
	
	
	
	
	
	
	
	
	
	
	
	
	
	
	
	
	
	
	
	
	
	
	
	
	
	
	
	
	
	
	
	
	
	
	
	
	
	
	
	
	
	
	
	
	
	
	
	
	
	
	
	
	
	
	
	
	
	
	
	
	
	
	
	
	
	
	
	
	
	
	
	
	
	
	
	
	
	
	
	
	
	
	
	
	
	
	
	
	
	
	
	
	
	
	
	
	
	
	
	
	
	
	
	
	
	
	
	
	
	
	
	
	
	
	
	
	
	
	
	
	
	
	
	
	
	
	
	
	
	
	
	
	
	
	
	
	
	
	
	
	
	
	
	
	
	
	
	
	
	
	
	
	
	
	
	
	
	
	
	
	
	
	
	
	
	
	
	
	
	
	
	
	
	
	
	
	
	
	
	
	
	
	
	
	
	
	
	
	
	
	
	
	
	
	
	
	
	
	
	
	
	
	
	
	
	
	
	
	
	
	
	
	
	
	
	
	
	
	
	
	
	
	
	
	
	
	
	
	
	
	
	
	
	
	
	
	
	
	
	
	
	
	
	
	
	
	
	
	
	
	
	
	
	
	
	
	
	
	
	
	
	
	
	
	
	
	
	
	
	
	
	
	
	
	
	
	
	
	
	
	
	
	
	
	
	
	
	
	
	
	
	
	
	
	
	
	
	
	
	
	
	
	
	
	
	
	
	
	
	
	
	
	
	
	
	
	
	
	
	
	
	
	
	
	
	
	
	
	
	
	
	
	
	
	
	
	
	
	
	
	
	
	
	
	
	
	
	
	
	
	
	
	
	
	
	
	
	
	
	
	
	
	
	
	
	
	
	
	
	
	
	
	
	
	
	
	
	
	
	
	
	
	
	
	
	
	
	
	
	
	
	
	
	
	
	
	
	
	
	
	
	
	
	
	
	
	
	
	
	
	
	
	
	
	
	
	
	
	
	
	
	
	
	
	
	
	
	
	
	
	
	
	
	
	
	
	
	
	
	
	
	
	
	
	
	
	
	
	
	
	
	
	
	
	
	
	
	
	
	
	
	
	
	
	
	
	
	
	
	
	
	
	
	
	
	
	
	
	
	
	
	
	
	
	
	
	
	
	
	
	
	
	
	
	
	
	
	
	
	
	
	
	
	
	
	
	
	
	
	
	
	
	
	
	
	
	
	
	
	
	
	
	
	
	
	
	
	
	
	
	
	
	
	
	
	
	
	
	
	
	
	
	
	
	
	
	
	
	
	
	
	
	
	
	
	
	
	
	
	
	
	
	
	
	
	
	
	
	
	
	
	
	
	
	
	
	
	
	
	
	
	
	
	
	
	
	
	
	
	
	
	
	
	
	
	
	
	
	
	
	
	
	
	
	
	
	
	
	
	
	
	
	
	
	
	
	
	
	
	
	
	
	
	
	
	
	
	
	
	
	
	
	
	
	
	
	
	
	
	
	
	
	
	
	
	
	
	
	
	
	
	
	
	
	
	
	
	
	
	
	
	
	
	
	
	
	
	
	
	
	
	
	
	
	
	
	
	
	
	
	
	
	
	
	
	
	
	
	
	
	
	
	
	
	
	
	
	
	
	
	
	
	
	
	
	
	
	
	
	
	
	
	
	
	
	
	
	
	
	
	
	
	
	
	
	
	
	
	
	
	
	
	
	
	
	
	
	
	
	
	
	
	
	
	
	
	
	
	
	
	
	
	
	
	
	
	
	
	
	
	
	
	
	
	
	
	
	
	
	
	
	
	
	
	
	
	
	
	
	
	
	
	
	
	
	
	
	
	
	
	
	
	
	
	
	
	
	
	
	
	
	
	
	
	
	
	
	
	
	
	
	
	
	
	
	
	
	
	
	
	
	
	
	
	
	
	
	
	
	
	
	
	
	
	
	
	
	
	
	
	
	
	
	
	
	
	
	
	
	
	
	
	
	
	
	
	
	
	
	
	
	
	
	
	
	
	
	
	
	
	
	
	
	
	
	
	
	
	
	
	
	
	
	
	
	
	
	
	
	
	
	
	
	
	
	
	
	
	
	
	
	
	
	
	
	
	
	
	
	
	
	
	
	
	
	
	
	
	
	
	
	
	
	
	
	
	
	
	
	
	
	
	
	
	
	
	
	
	
	
	
	
	
	
	
	
	
	
	
	
	
	
	
	
	
	
	
	
	
	
	
	
	
	
	
	
	
	
	
	
	
	
	
	
	
	
	
	
	
	
	
	
	
	
	
	
	
	
	
	
	
	
	
	
	
	
	
	
	
	
	
	
	
	
	
	
	
	
	
	
	
	
	
	
	
	
	
	
	
	
	
	
	
	
	
	
	
	
	
	
	
	
	
	
	
	
	
	
	
	
	
	
	
	
	
	
	
	
	
	
	
	
	
	
	
	
	
	
	
	
	
	
	
	
	
	
	
	
	
	
	
	
	
	
	
	
	
	
	
	
	
	
	
	
	
	
	
	
	
	
	
	
	
	
	
	
	
	
	
	
	
	
	
	
	
	
	
	
	
	
	
	
	
	
	
	
	
	
	
	
	
	
	
	
	
	
	
	
	
	
	
	
	
	
	
	
	
	
	
	
	
	
	
	
	
	
	
	
	
	
	
	
	
	
	
	
	
	
	
	
	
	
	
	
	
	
	
	
	
	
	
	
	
	
	
	
	
	
	
	
	
	
	
	
	
	
	
	
	
	
	
	
	
	
	
	
	
	
	
	
	
	
	
	
	
	
	
	
	
	
	
	
	
	
	
	
	
	
	
	
	
	
	
	
	
	
	
	
	
	
	
	
	
	
	
	
	
	
	
	
	
	
	
	
	
	
	
	
	
	
	
	
	
	
	
	
	
	
	
	
	
	
	
	
	
	
	
	
	
	
	
	
	
	
	
	
	
	
	
	
	
	
	
	
	
	
	
	
	
	
	
	
	
	
	
	
	
	
	
	
	
	
	
	
	
	
	
	
	
	
	
	
	
	
	
	
	
	
	
	
	
	
	
	
	
	
	
	
	
	
	
	
	
	
	
	
	
	
	
	
	
	
	
	
	
	
	
	
	
	
	
	
	
	
	
	
	
	
	
	
	
	
	
	
	
	
	
	
	
	
	
	
	
	
	
	
	
	
	
	
	
	
	
	
	
	
	
	
	
	
	
	
	
	
	
	
	
	
	
	
	
	
	
	
	
	
	
	
	
	
	
	
	
	
	
	
	
	
	
	
	
	
	
	
	
	
	
	
	
	
	
	
	
	
	
	
	
	
	
	
	
	
	
	
	
	
	
	
	
	
	
	
	
	
	
	
	
	
	
	
	
	
	
	
	
	
	
	
	
	
	
	
	
	
	
	
	
	
	
	
	
	
	
	
	
	
	
	
	
	
	
	
	
	
	
	
	
	
	
	
	
	
	
	
	
	
	
	
	
	
	
	
	
	
	
	
	
	
	
	
	
	
	
	
	
	
	
	
	
	
	
	
	
	
	
	
	
	
	
	
	
	
	
	
	
	
	
	
	
	
	
	
	
	
	
	
	
	
	
	
	
	
	
	
	
	
	
	
	
	
	
	
	
	
	
	
	
	
	
	
	
	
	
	
	
	
	
	
	
	
	
	
	
	
	
	
	
	
	
	
	
	
	
	
	
	
	
	
	
	
	
	
	
	
	
	
	
	
	
	
	
	
	
	
	
	
	
	
	
	
	
	
	
	
	
	
	
	
	
	
	
	
	
	
	
	
	
	
	
	
	
	
	
	
	
	
	
	
	
	
	
	
	
	
	
	
	
	
	
	
	
	
	
	
	
	
	
	
	
	
	
	
	
	
	
	
	
	
	
	
	
	
	
	
	
	
	
	
	
	
	
	
	
	
	
	
	
	
	
	
	
	
	
	
	
	
	
	
	
	
	
	
	
	
	
	
	
	
	
	
	
	
	
	
	
	
	
	
	
	
	
	
	
	
	
	
	
	
	
	
	
	
	
	
	
	
	
	
	
	
	
	
	
	
	
	
	
	
	
	
	
	
	
	
	
	
	
	
	
	
	
	
	
	
	
	
	
	
	
	
	
	
	
	
	
	
	
	
	
	
	
	
	
	
	
	
	
	
	
	
	
	
	
	
	
	
	
	
	
	
	
	
	
	
	
	
	
	
	
	
	
	
	
	
	
	
	
	
	
	
	
	
	
	
	
	
	
	
	
	
	
	
	
	
	
	
	
	
	
	
	
	
	
	
	
	
	
	
	
	
	
	
	
	
	
	
	
	
	
	
	
	
	
	
	
	
	
	
	
	
	
	
	
	
	
	
	
	
	
	
	
	
	
	
	
	
	
	
	
	
	
	
	
	
	
	
	
	
	
	
	
	
	
	
	
	
	
	
	
	
	
	
	
	
	
	
	
	
	
	
	
	
	
	
	
	
	
	
	
	
	
	
	
	
	
	
	
	
	
	
	
	
	
	
	
	
	
	
	
	
	
	
	
	
	
	
	
	
	
	
	
	
	
	
	
	
	
	
	
	
	
	
	
	
	
	
	
	
	
	
	
	
	
	
	
	
	
	
	
	
	
	
	
	
	
	
	
	
	
	
	
	
	
	
	
	
	
	
	
	
	
	
	
	
	
	
	
	
	
	
	
	
	
	
	
	
	
	
	
	
	
	
	
	
	
	
	
	
	
	
	
	
	
	
	
	
	
	
	
	
	
	
	
	
	
	
	
	
	
	
	
	
	
	
	
	
	
	
	
	
	
	
	
	
	
	
	
	
	
	
	
	
	
	
	
	
	
	
	
	
	
	
	
	
	
	
	
	
	
	
	
	
	
	
	
	
	
	
	
	
	
	
	
	
	
	
	
	
	
	
	
	
	
	
	
	
	
	
	
	
	
	
	
	
	
	
	
	
	
	
	
	
	
	
	
	
	
	
	
	
	
	
	
	
	
	
	
	
	
	
	
	
	
	
	
	
	
	
	
	
	
	
	
	
	
	
	
	
	
	
	
	
	
	
	
	
	
	
	
	
	
	
	
	
	
	
	
	
	
	
	
	
	
	
	
	
	
	
	
	
	
	
	
	
	
	
	
	
	
	
	
	
	
	
	
	
	
	
	
	
	
	
	
	
	
	
	
	
	
	
	
	
	
	
	
	
	
	
	
	
	
	
	
	
	
	
	
	
	
	
	
	
	
	
	
	
	
	
	
	
	
	
	
	
	
	
	
	
	
	
	
	
	
	
	
	
	
	
	
	
	
	
	
	
	
	
	
	
	
	
	
	
	
	
	
	
	
	
	
	
	
	
	
	
	
	
	
	
	
	
	
	
	
	
	
	
	
	
	
	
	
	
	
	
	
	
	
	
	
	
	
	
	
	
	
	
	
	
	
	
	
	
	
	
	
	
	
	
	
	
	
	
	
	
	
	
	
	
	
	
	
	
	
	
	
	
	
	
	
	
	
	
	
	
	
	
	
	
	
	
	
	
	
	
	
	
	
	
	
	
	
	
	
	
	
	
	
	
	
	
	
	
	
	
	
	
	
	
	
	
	
	
	
	
	
	
	
	
	
	
	
	
	
	
	
	
	
	
	
	
	
	
	
	
	
	
	
	
	
	
	
	
	
	
	
	
	
	
	
	
	
	
	
	
	
	
	
	
	
	
	
	
	
	
	
	
	
	
豈	豈
更	更
車	車
賈	賈
滑	滑
串	串
句	句
龜	龜
龜	龜
契	契
金	金
喇	喇
奈	奈
懶	懶
癩	癩
羅	羅
蘿	蘿
螺	螺
裸	裸
邏	邏
樂	樂
洛	洛
烙	烙
珞	珞
落	落
酪	酪
駱	駱
亂	亂
卵	卵
欄	欄
爛	爛
蘭	蘭
鸞	鸞
嵐	嵐
濫	濫
藍	藍
襤	襤
拉	拉
臘	臘
蠟	蠟
廊	廊
朗	朗
浪	浪
狼	狼
郎	郎
來	來
冷	冷
勞	勞
擄	擄
櫓	櫓
爐	爐
盧	盧
老	老
蘆	蘆
虜	虜
路	路
露	露
魯	魯
鷺	鷺
碌	碌
祿	祿
綠	綠
菉	菉
錄	錄
鹿	鹿
論	論
壟	壟
弄	弄
籠	籠
聾	聾
牢	牢
磊	磊
賂	賂
雷	雷
壘	壘
屢	屢
樓	樓
淚	淚
漏	漏
累	累
縷	縷
陋	陋
勒	勒
肋	肋
凜	凜
凌	凌
稜	稜
綾	綾
菱	菱
陵	陵
讀	讀
拏	拏
樂	樂
諾	諾
丹	丹
寧	寧
怒	怒
率	率
異	異
北	北
磻	磻
便	便
復	復
不	不
泌	泌
數	數
索	索
參	參
塞	塞
省	省
葉	葉
說	說
殺	殺
辰	辰
沈	沈
拾	拾
若	若
掠	掠
略	略
亮	亮
兩	兩
凉	凉
梁	梁
糧	糧
良	良
諒	諒
量	量
勵	勵
呂	呂
女	女
廬	廬
旅	旅
濾	濾
礪	礪
閭	閭
驪	驪
麗	麗
黎	黎
力	力
曆	曆
歷	歷
轢	轢
年	年
憐	憐
戀	戀
撚	撚
漣	漣
煉	煉
璉	璉
秊	秊
練	練
聯	聯
輦	輦
蓮	蓮
連	連
鍊	鍊
列	列
劣	劣
咽	咽
烈	烈
裂	裂
說	說
廉	廉
念	念
捻	捻
殮	殮
簾	簾
獵	獵
令	令
囹	囹
寧	寧
嶺	嶺
怜	怜
玲	玲
瑩	瑩
羚	羚
聆	聆
鈴	鈴
零	零
靈	靈
領	領
例	例
禮	禮
醴	醴
隸	隸
惡	惡
了	了
僚	僚
寮	寮
尿	尿
料	料
樂	樂
燎	燎
療	療
蓼	蓼
遼	遼
龍	龍
暈	暈
阮	阮
劉	劉
杻	杻
柳	柳
流	流
溜	溜
琉	琉
留	留
硫	硫
紐	紐
類	類
六	六
戮	戮
陸	陸
倫	倫
崙	崙
淪	淪
輪	輪
律	律
慄	慄
栗	栗
率	率
隆	隆
利	利
吏	吏
履	履
易	易
李	李
梨	梨
泥	泥
理	理
痢	痢
罹	罹
裏	裏
裡	裡
里	里
離	離
匿	匿
溺	溺
吝	吝
燐	燐
璘	璘
藺	藺
隣	隣
鱗	鱗
麟	麟
林	林
淋	淋
臨	臨
立	立
笠	笠
粒	粒
狀	狀
炙	炙
識	識
什	什
茶	茶
刺	刺
切	切
度	度
拓	拓
糖	糖
宅	宅
洞	洞
暴	暴
輻	輻
行	行
降	降
見	見
廓	廓
兀	兀
嗀	嗀
﨎	﨎
﨏	﨏
塚	塚
﨑	﨑
晴	晴
﨓	﨓
﨔	﨔
凞	凞
猪	猪
益	益
礼	礼
神	神
祥	祥
福	福
靖	靖
精	精
羽	羽
﨟	﨟
蘒	蘒
﨡	﨡
諸	諸
﨣	﨣
﨤	﨤
逸	逸
都	都
﨧	﨧
﨨	﨨
﨩	﨩
飯	飯
飼	飼
館	館
鶴	鶴
